AAAATAGTGAT -> AAATAGTGATC
AAAATATTAAG -> AAATATTAAGA
AAAATCCGTTC -> AAATCCGTTCA
AAACATTATTA -> AACATTATTAG
AAACCATTACC -> AACCATTACCA
AAACCGCGTTG -> AACCGCGTTGA
AAACGCCTCTA -> AACGCCTCTAT
AAACTCATGGG -> AACTCATGGGC
AAACTGACTAG -> AACTGACTAGT
AAAGCGACAGA -> AAGCGACAGAA
AAAGGTGAACA -> AAGGTGAACAC
AAAGTCCCGTA -> AAGTCCCGTAG
AAAGTCGAATG -> AAGTCGAATGC
AAATAAGCTTA -> AATAAGCTTAA
AAATAGTGATC -> AATAGTGATCT
AAATATTAAGA -> AATATTAAGAA
AAATCCGCCAA -> AATCCGCCAAG
AAATCCGTTCA -> AATCCGTTCAG
AAATCGTGTCC -> AATCGTGTCCC
AAATGCACACT -> AATGCACACTC
AAATTCCCTCT -> AATTCCCTCTT
AAATTGGTTCT -> AATTGGTTCTT
AACAACCGAAC -> ACAACCGAACC
AACAACGGGGC -> ACAACGGGGCC
AACACCTTAAT -> ACACCTTAATC
AACACGGCTTG -> ACACGGCTTGC
AACACTATATA -> ACACTATATAC
AACAGTAAGCC -> ACAGTAAGCCC
AACAGTGAAGC -> ACAGTGAAGCC
AACATTATTAG -> ACATTATTAGC
AACCAATCGCC -> ACCAATCGCCT
AACCACATGCG -> ACCACATGCGT
AACCATCCAAT -> ACCATCCAATC
AACCATTACCA -> ACCATTACCAG
AACCCCATCGA -> ACCCCATCGAG
AACCCGGGCGA -> ACCCGGGCGAG
AACCCTCTTCA -> ACCCTCTTCAC
AACCGAACCAA -> ACCGAACCAAT
AACCGCGTTGA -> ACCGCGTTGAA
AACCGTGTATA -> ACCGTGTATAG
AACCTTGTATT -> ACCTTGTATTG
AACGACCCGAT -> ACGACCCGATT
AACGCCCGATA -> ACGCCCGATAT
AACGCCTCTAT -> ACGCCTCTATC
AACGCTGAAGC -> ACGCTGAAGCG
AACGGCGTATG -> ACGGCGTATGA
AACGGGGCCGA -> ACGGGGCCGAT
AACGTCCCCAA -> ACGTCCCCAAG
AACTCATGGGC -> ACTCATGGGCG
AACTGACTAGT -> ACTGACTAGTT
AAGAATGGAGA -> AGAATGGAGAG
AAGACCAAACT -> AGACCAAACTG
AAGAGTAGCCT -> AGAGTAGCCTG
AAGATACGAGG -> AGATACGAGGA
AAGATTGCCGG -> AGATTGCCGGC
AAGCAATCTCG -> AGCAATCTCGC
AAGCACGGTGG -> AGCACGGTGGG
AAGCAGACTAT -> AGCAGACTATA
AAGCATTGCGT -> AGCATTGCGTG
AAGCCCCCCTA -> AGCCCCCCTAA
AAGCCGAGTGG -> AGCCGAGTGGT
AAGCCGTTGGG -> AGCCGTTGGGG
AAGCCTCACGA -> AGCCTCACGAA
AAGCCTCTACC -> AGCCTCTACCT
AAGCGACAGAA -> AGCGACAGAAG
AAGCGCTTGCC -> AGCGCTTGCCG
AAGCGGATACT -> AGCGGATACTT
AAGCGGTATAG -> AGCGGTATAGG
AAGGCAACACG -> AGGCAACACGG
AAGGCAGTACC -> AGGCAGTACCA
AAGGCATTTTT -> AGGCATTTTTC
AAGGCCGATTG -> AGGCCGATTGG
AAGGCCTGTCT -> AGGCCTGTCTC
AAGGCGAGGAG -> AGGCGAGGAGG
AAGGGAAGCAT -> AGGGAAGCATT
AAGGGCCTCCT -> AGGGCCTCCTG
AAGGTCAGGTG -> AGGTCAGGTGT
AAGGTGAACAC -> AGGTGAACACC
AAGTATAAGTT -> AGTATAAGTTC
AAGTCCCGTAG -> AGTCCCGTAGT
AAGTCGAATGC -> AGTCGAATGCT
AAGTGAGTTGT -> AGTGAGTTGTT
AAGTGCTGACC -> AGTGCTGACCT
AAGTGTTAGAC -> AGTGTTAGACA
AAGTTAGCTGG -> AGTTAGCTGGG
AAGTTCTGTAG -> AGTTCTGTAGG
AATAAAATAGT -> ATAAAATAGTG
AATAACCCTCT -> ATAACCCTCTT
AATAATCTGGA -> ATAATCTGGAG
AATAATTCAAA -> ATAATTCAAAT
AATACAGTAAT -> ATACAGTAATA
AATACCCGCAT -> ATACCCGCATC
AATACTACAAT -> ATACTACAATT
AATAGTGATCT -> ATAGTGATCTA
AATATCCGACT -> ATATCCGACTA
AATATGGGTTG -> ATATGGGTTGC
AATATTAAGAA -> ATATTAAGAAT
AATCACCACCT -> ATCACCACCTC
AATCATCAATC -> ATCATCAATCC
AATCCACCTAA -> ATCCACCTAAG
AATCCCCCCTA -> ATCCCCCCTAA
AATCCCCTTGC -> ATCCCCTTGCC
AATCCGCCAAG -> ATCCGCCAAGC
AATCCGTTCAG -> ATCCGTTCAGC
AATCGCCTGCC -> ATCGCCTGCCG
AATCGTGTCCC -> ATCGTGTCCCT
AATCTAAATCC -> ATCTAAATCCG
AATCTAGGTAG -> ATCTAGGTAGG
AATCTCAGGTG -> ATCTCAGGTGG
AATCTCGCAGT -> ATCTCGCAGTA
AATCTGGAGTC -> ATCTGGAGTCA
AATCTTAAGCC -> ATCTTAAGCCG
AATGAAAATCC -> ATGAAAATCCG
AATGCAATATC -> ATGCAATATCC
AATGCACACTC -> ATGCACACTCA
AATGCTCTTTC -> ATGCTCTTTCA
AATGGAACGGC -> ATGGAACGGCG
AATGGAGAGAA -> ATGGAGAGAAG
AATGGGCCATC -> ATGGGCCATCT
AATGGGCGCAG -> ATGGGCGCAGG
AATGTCTATTC -> ATGTCTATTCT
AATGTTCGAAG -> ATGTTCGAAGG
AATTACCTGGT -> ATTACCTGGTA
AATTCAAATGC -> ATTCAAATGCA
AATTCAAATTC -> ATTCAAATTCC
AATTCAAGGGA -> ATTCAAGGGAA
AATTCCCTCTT -> ATTCCCTCTTG
AATTCCTCATC -> ATTCCTCATCT
AATTGCTCGTA -> ATTGCTCGTAT
AATTGGATGAG -> ATTGGATGAGG
AATTGGCGCGA -> ATTGGCGCGAT
AATTGGTTCTT -> ATTGGTTCTTC
ACAAATAAGCT -> CAAATAAGCTT
ACAACAGTGAA -> CAACAGTGAAG
ACAACCGAACC -> CAACCGAACCA
ACAACGGGGCC -> CAACGGGGCCG
ACAAGTGTTAG -> CAAGTGTTAGA
ACAATTCAAAT -> CAATTCAAATT
ACAATTCAAGG -> CAATTCAAGGG
ACACACTCCCG -> CACACTCCCGA
ACACCACGTTG -> CACCACGTTGC
ACACCTTAATC -> CACCTTAATCT
ACACGGCTTGC -> CACGGCTTGCG
ACACTATATAC -> CACTATATACG
ACACTCACTGG -> CACTCACTGGA
ACACTCCCGAA -> CACTCCCGAAG
ACAGAAGGCAA -> CAGAAGGCAAC
ACAGACGTTCA -> CAGACGTTCAA
ACAGCCCCAAT -> CAGCCCCAATC
ACAGGCTAATC -> CAGGCTAATCT
ACAGTAAGCCC -> CAGTAAGCCCC
ACAGTAATACC -> CAGTAATACCC
ACAGTGAAGCC -> CAGTGAAGCCT
ACAGTTGCACA -> CAGTTGCACAT
ACATCGTCAGT -> CATCGTCAGTT
ACATCTTCTCT -> CATCTTCTCTC
ACATGATCACT -> CATGATCACTG
ACATGCGTTTC -> CATGCGTTTCT
ACATTATTAGC -> CATTATTAGCG
ACATTCCTAGG -> CATTCCTAGGA
ACCAAACCGCG -> CCAAACCGCGT
ACCAAACTGAC -> CCAAACTGACT
ACCAACCACAT -> CCAACCACATG
ACCAATCGCCT -> CCAATCGCCTG
ACCAATGGGCC -> CCAATGGGCCA
ACCACATGCGT -> CCACATGCGTT
ACCACCCATAA -> CCACCCATAAC
ACCACCGGACT -> CCACCGGACTA
ACCACCTCGGG -> CCACCTCGGGT
ACCACGTTGCG -> CCACGTTGCGC
ACCAGAGTCGC -> CCAGAGTCGCT
ACCATCCAATC -> CCATCCAATCC
ACCATTACCAG -> CCATTACCAGA
ACCCATAACGT -> CCCATAACGTC
ACCCCATCGAG -> CCCCATCGAGG
ACCCCTAAGAT -> CCCCTAAGATA
ACCCGATTAAC -> CCCGATTAACC
ACCCGCATCGC -> CCCGCATCGCA
ACCCGGGCGAG -> CCCGGGCGAGC
ACCCTCTTCAC -> CCCTCTTCACG
ACCGAACCAAT -> CCGAACCAATC
ACCGCGTTGAA -> CCGCGTTGAAG
ACCGGACTAAA -> CCGGACTAAAC
ACCGGTAGGCG -> CCGGTAGGCGG
ACCGTGTATAG -> CCGTGTATAGG
ACCTAAGCAAT -> CCTAAGCAATC
ACCTCCTTACT -> CCTCCTTACTC
ACCTCGGGTTG -> CCTCGGGTTGC
ACCTGGTAGTG -> CCTGGTAGTGG
ACCTGGTCGCT -> CCTGGTCGCTT
ACCTTAATCTT -> CCTTAATCTTA
ACCTTCCCGTA -> CCTTCCCGTAC
ACCTTGTATTG -> CCTTGTATTGG
ACGAACAGTAA -> CGAACAGTAAG
ACGAATTGGAT -> CGAATTGGATG
ACGACCCGATT -> CGACCCGATTA
ACGAGGAAGTA -> CGAGGAAGTAT
ACGATAGGTCA -> CGATAGGTCAG
ACGCCCGATAT -> CGCCCGATATG
ACGCCTCTATC -> CGCCTCTATCC
ACGCGGTCGGA -> CGCGGTCGGAA
ACGCTGAAGCG -> CGCTGAAGCGG
ACGGCGTATGA -> CGGCGTATGAA
ACGGCTTGCGT -> CGGCTTGCGTC
ACGGGGCCGAT -> CGGGGCCGATT
ACGGTGAGCAG -> CGGTGAGCAGG
ACGGTGGGATA -> CGGTGGGATAC
ACGTACCACCG -> CGTACCACCGG
ACGTAGTAATT -> CGTAGTAATTA
ACGTCATCAAG -> CGTCATCAAGA
ACGTCCCCAAG -> CGTCCCCAAGG
ACGTGAGGCTG -> CGTGAGGCTGT
ACGTTCAAGGT -> CGTTCAAGGTC
ACGTTGCGCTA -> CGTTGCGCTAT
ACGTTTCATAC -> CGTTTCATACC
ACTAAACCATT -> CTAAACCATTA
ACTACAATTCA -> CTACAATTCAA,CTACAATTCAA
ACTACCACCCA -> CTACCACCCAT
ACTAGAATCCC -> CTAGAATCCCC
ACTAGTTAGTA -> CTAGTTAGTAT
ACTATACTCAC -> CTATACTCACA
ACTATATACGA -> CTATATACGAT
ACTATCCGTCA -> CTATCCGTCAT
ACTATTAAAGT -> CTATTAAAGTC
ACTCAACACTA -> CTCAACACTAT
ACTCACAGACG -> CTCACAGACGT
ACTCACTGGAA -> CTCACTGGAAG
ACTCATGGGCG -> CTCATGGGCGC
ACTCCCCCTAT -> CTCCCCCTATT
ACTCCCGAAGA -> CTCCCGAAGAT
ACTGACTAGTT -> CTGACTAGTTA
ACTGATATATC -> CTGATATATCG
ACTGCTCATGA -> CTGCTCATGAA
ACTGGAAGGCC -> CTGGAAGGCCT
ACTGTAATCAT -> CTGTAATCATC
ACTGTCCCAGA -> CTGTCCCAGAT
ACTGTGAAAAT -> CTGTGAAAATA
ACTGTGTGAAA -> CTGTGTGAAAG
ACTTACTTCTT -> CTTACTTCTTA
ACTTATTCTGA -> CTTATTCTGAA
ACTTCCTCAAT -> CTTCCTCAATG
ACTTCTTAAGG -> CTTCTTAAGGC
AGAACGACCCG -> GAACGACCCGA
AGAAGAGTAGC -> GAAGAGTAGCC
AGAAGGCAACA -> GAAGGCAACAC
AGAATCCCCTT -> GAATCCCCTTG
AGAATGCAATA -> GAATGCAATAT
AGAATGGAGAG -> GAATGGAGAGA
AGAATTGCTCG -> GAATTGCTCGT
AGACAGCCCCA -> GACAGCCCCAA
AGACAGTTGCA -> GACAGTTGCAC
AGACCAAACCG -> GACCAAACCGC
AGACCAAACTG -> GACCAAACTGA
AGACGTGAGGC -> GACGTGAGGCT
AGACGTTCAAG -> GACGTTCAAGG
AGACTATACTC -> GACTATACTCA
AGACTGATATA -> GACTGATATAT
AGAGAAGAGTA -> GAGAAGAGTAG
AGAGGTACGAA -> GAGGTACGAAT
AGAGTAGCCTG -> GAGTAGCCTGG
AGAGTCGCTCA -> GAGTCGCTCAC
AGAGTTGTCGG -> GAGTTGTCGGC
AGATACGAGGA -> GATACGAGGAA
AGATAGTCTTA -> GATAGTCTTAC
AGATTGCCGGC -> GATTGCCGGCC
AGCAATCTCGC -> GCAATCTCGCA
AGCACGGTGGG -> GCACGGTGGGA
AGCAGACTATA -> GCAGACTATAC
AGCAGCAGGGT -> GCAGCAGGGTC
AGCAGCGTTCG -> GCAGCGTTCGT
AGCAGGCTAGT -> GCAGGCTAGTC
AGCAGGGAACG -> GCAGGGAACGC
AGCAGGGTCTG -> GCAGGGTCTGT
AGCATTACTCC -> GCATTACTCCC
AGCATTGCGTG -> GCATTGCGTGG
AGCCATCACCT -> GCCATCACCTG
AGCCCCAATCT -> GCCCCAATCTA
AGCCCCCCTAA -> GCCCCCCTAAA
AGCCGAGTGGT -> GCCGAGTGGTT
AGCCGTTGGGG -> GCCGTTGGGGC
AGCCTCACGAA -> GCCTCACGAAC
AGCCTCTACCT -> GCCTCTACCTT
AGCCTGGAGAC -> GCCTGGAGACG
AGCGACAGAAG -> GCGACAGAAGG
AGCGCTTGCCG -> GCGCTTGCCGT
AGCGGATACTT -> GCGGATACTTC
AGCGGTATAGG -> GCGGTATAGGG
AGCGTGGTGGT -> GCGTGGTGGTG
AGCGTTCGTCG -> GCGTTCGTCGT
AGCTGAGGAGT -> GCTGAGGAGTG
AGCTGCAAAGT -> GCTGCAAAGTC
AGCTGGGCAGT -> GCTGGGCAGTG
AGCTTTTCAAC -> GCTTTTCAACG
AGGAAGTATAA -> GGAAGTATAAG
AGGAATAAAAT -> GGAATAAAATA
AGGAATAATTC -> GGAATAATTCA
AGGAGACTGAT -> GGAGACTGATA
AGGAGGAATAA -> GGAGGAATAAT
AGGAGGATCGC -> GGAGGATCGCG
AGGAGTGCAAG -> GGAGTGCAAGT
AGGATCGCGCG -> GGATCGCGCGA
AGGCAACACGG -> GGCAACACGGC
AGGCAGTACCA -> GGCAGTACCAA
AGGCATTTTTC -> GGCATTTTTCG
AGGCCACATCG -> GGCCACATCGT
AGGCCGATTGG -> GGCCGATTGGG
AGGCCGTACAC -> GGCCGTACACC
AGGCCTGTCTC -> GGCCTGTCTCA
AGGCGAGGAGG -> GGCGAGGAGGA
AGGCGGTAGAC -> GGCGGTAGACC
AGGCTAATCTA -> GGCTAATCTAG
AGGCTAGTCGT -> GGCTAGTCGTC
AGGCTGAATAT -> GGCTGAATATG
AGGCTGACTGT -> GGCTGACTGTG
AGGCTGTGGTC -> GGCTGTGGTCC
AGGGAACGCTG -> GGGAACGCTGA
AGGGAAGCATT -> GGGAAGCATTG
AGGGAAGGCGA -> GGGAAGGCGAG
AGGGCCTCCTG -> GGGCCTCCTGG
AGGGGATTTTG -> GGGGATTTTGT
AGGGGTGGAGT -> GGGGTGGAGTT
AGGGTATGATG -> GGGTATGATGC
AGGGTCCCGAA -> GGGTCCCGAAC
AGGGTCTGTTA -> GGGTCTGTTAA
AGGTACGAATT -> GGTACGAATTG
AGGTAGGTGGA -> GGTAGGTGGAG
AGGTCAGGTGG -> GGTCAGGTGGT
AGGTCAGGTGT -> GGTCAGGTGTC
AGGTGAACACC -> GGTGAACACCT
AGGTGGAGCTG -> GGTGGAGCTGA
AGGTGGAGCTT -> GGTGGAGCTTT
AGGTGGTGGCG -> GGTGGTGGCGC
AGGTGTCGTGT -> GGTGTCGTGTG
AGTAAACATTA -> GTAAACATTAT
AGTAAGCCCCC -> GTAAGCCCCCC
AGTAAGCCTCT -> GTAAGCCTCTA
AGTAATACCCG -> GTAATACCCGC
AGTAATTACCT -> GTAATTACCTG
AGTACCAATGG -> GTACCAATGGG
AGTACCGGTAG -> GTACCGGTAGG
AGTAGCCTGGA -> GTAGCCTGGAG
AGTATAAGTTC -> GTATAAGTTCT
AGTATTCCAGA -> GTATTCCAGAG
AGTCATAAGCA -> GTCATAAGCAC
AGTCCCGTAGT -> GTCCCGTAGTC
AGTCCTATCGT -> GTCCTATCGTG
AGTCGAATGCT -> GTCGAATGCTC
AGTCGCGCCAA -> GTCGCGCCAAC
AGTCGCTCACC -> GTCGCTCACCA
AGTCGTCTGTG -> GTCGTCTGTGA
AGTCTTACTAG -> GTCTTACTAGA
AGTGAAGCCTC -> GTGAAGCCTCA
AGTGAGTTGTT -> GTGAGTTGTTA
AGTGATCTAGC -> GTGATCTAGCA
AGTGCAAGTGC -> GTGCAAGTGCT
AGTGCTGACCT -> GTGCTGACCTC
AGTGGCTAATC -> GTGGCTAATCT
AGTGGGCGATG -> GTGGGCGATGA
AGTGGTTATAT -> GTGGTTATATC
AGTGTTAGACA -> GTGTTAGACAG
AGTTACGTCAT -> GTTACGTCATC
AGTTAGCTGGG -> GTTAGCTGGGC
AGTTAGTATTC -> GTTAGTATTCC
AGTTCTGTAGG -> GTTCTGTAGGC
AGTTGCACATT -> GTTGCACATTC
AGTTGGTTGTA -> GTTGGTTGTAA
AGTTGTCGGCC -> GTTGTCGGCCG
AGTTGTTAATA -> GTTGTTAATAA
AGTTTCAGAAT -> GTTTCAGAATT
ATAAAATAGTG -> TAAAATAGTGA
ATAACCCTCTT -> TAACCCTCTTC
ATAACGTCCCC -> TAACGTCCCCA
ATAAGCACGGT -> TAAGCACGGTG
ATAAGTTCTGT -> TAAGTTCTGTA
ATAATCTGGAG -> TAATCTGGAGT
ATAATTCAAAT -> TAATTCAAATG
ATACAGTAATA -> TACAGTAATAC
ATACATCTTCT -> TACATCTTCTC
ATACCCCTAAG -> TACCCCTAAGA
ATACCCGCATC -> TACCCGCATCG
ATACGAGGAAG -> TACGAGGAAGT
ATACGATAGGT -> TACGATAGGTC
ATACTACAATT -> TACTACAATTC
ATACTCACAGA -> TACTCACAGAC
ATACTTCCTCA -> TACTTCCTCAA
ATAGACAGCCC -> TAGACAGCCCC
ATAGCAGCAGG -> TAGCAGCAGGG
ATAGGCTGAAT -> TAGGCTGAATA
ATAGGGGATTT -> TAGGGGATTTT
ATAGGTCAGGT -> TAGGTCAGGTG
ATAGTCTTACT -> TAGTCTTACTA
ATAGTGATCTA -> TAGTGATCTAG
ATATACGATAG -> TATACGATAGG
ATATATCGAAA -> TATATCGAAAC
ATATCCGACTA -> TATCCGACTAC
ATATCGAAACT -> TATCGAAACTC
ATATCTAATTG -> TATCTAATTGG
ATATCTGTATG -> TATCTGTATGC
ATATGATGCTA -> TATGATGCTAC
ATATGGGTTGC -> TATGGGTTGCG
ATATTAAGAAT -> TATTAAGAATG
ATCAAGACCAA -> TCAAGACCAAA
ATCAATCCCCC -> TCAATCCCCCC
ATCACCACCTC -> TCACCACCTCG
ATCACCTGGTC -> TCACCTGGTCG
ATCACTGCTCA -> TCACTGCTCAT
ATCAGGAGGAT -> TCAGGAGGATC
ATCATCAATCC -> TCATCAATCCC
ATCCAATCCAC -> TCCAATCCACC
ATCCACCTAAG -> TCCACCTAAGC
ATCCCCCCTAA -> TCCCCCCTAAT
ATCCCCTTGCC -> TCCCCTTGCCC
ATCCCTCCGGC -> TCCCTCCGGCA
ATCCGACTACA -> TCCGACTACAA
ATCCGAGTCGC -> TCCGAGTCGCG
ATCCGCCAAGC -> TCCGCCAAGCA
ATCCGTCATAT -> TCCGTCATATC
ATCCGTTCAGC -> TCCGTTCAGCT
ATCGAAACTCA -> TCGAAACTCAT
ATCGACTGTAA -> TCGACTGTAAT
ATCGAGGGGTG -> TCGAGGGGTGG
ATCGCACTATT -> TCGCACTATTA
ATCGCCTGCCG -> TCGCCTGCCGT
ATCGCGCGACT -> TCGCGCGACTA
ATCGCTAAGTT -> TCGCTAAGTTA
ATCGGAACCCG -> TCGGAACCCGG
ATCGTCAGTTA -> TCGTCAGTTAC
ATCGTGGGGTT -> TCGTGGGGTTC
ATCGTGTCCCT -> TCGTGTCCCTA
ATCTAAATCCG -> TCTAAATCCGC
ATCTAATTGGC -> TCTAATTGGCG
ATCTAGCATTA -> TCTAGCATTAC
ATCTAGGTAGG -> TCTAGGTAGGT
ATCTAGTTGGT -> TCTAGTTGGTT
ATCTCAGGTGG -> TCTCAGGTGGA
ATCTCGAGTAA -> TCTCGAGTAAA
ATCTCGCAGTA -> TCTCGCAGTAA
ATCTGGAGTCA -> TCTGGAGTCAT
ATCTGTATGCT -> TCTGTATGCTC
ATCTTAACAAC -> TCTTAACAACG
ATCTTAAGCCG -> TCTTAAGCCGA
ATCTTCTCTCT -> TCTTCTCTCTA
ATGAAAATCCG -> TGAAAATCCGT
ATGAAATCGTG -> TGAAATCGTGT
ATGAAGCCGTT -> TGAAGCCGTTG
ATGACGTAGTA -> TGACGTAGTAA
ATGAGGGAAGG -> TGAGGGAAGGC
ATGAGTACCGG -> TGAGTACCGGT
ATGATCACTGC -> TGATCACTGCT
ATGATGCACAA -> TGATGCACAAC
ATGATGCTACG -> TGATGCTACGT
ATGCAATATCC -> TGCAATATCCG
ATGCACAACAG -> TGCACAACAGT
ATGCACACTCA -> TGCACACTCAC
ATGCGTTTCTT -> TGCGTTTCTTA
ATGCTACGTAC -> TGCTACGTACC
ATGCTCTCAAG -> TGCTCTCAAGC
ATGCTCTTTCA -> TGCTCTTTCAT
ATGGAACGGCG -> TGGAACGGCGT
ATGGAGAGAAG -> TGGAGAGAAGA
ATGGCATCAGG -> TGGCATCAGGA
ATGGGCCATCT -> TGGGCCATCTC
ATGGGCGCAGG -> TGGGCGCAGGC
ATGGGCGCCGA -> TGGGCGCCGAC
ATGGGTTGCGC -> TGGGTTGCGCC
ATGTCTATTCT -> TGTCTATTCTA
ATGTTCGAAGG -> TGTTCGAAGGG
ATTAAAGTCGA -> TTAAAGTCGAA
ATTAACCTTGT -> TTAACCTTGTA
ATTAAGAATGG -> TTAAGAATGGA
ATTAAGTGAGT -> TTAAGTGAGTT
ATTACCAGAGT -> TTACCAGAGTC
ATTACCTGGTA -> TTACCTGGTAG
ATTACTCCCCC -> TTACTCCCCCT
ATTAGCGTGGT -> TTAGCGTGGTG
ATTATGGCATC -> TTATGGCATCA
ATTATTAGCGT -> TTATTAGCGTG
ATTCAAATGCA -> TTCAAATGCAC
ATTCAAATTCC -> TTCAAATTCCC
ATTCAAGGGAA -> TTCAAGGGAAG
ATTCCAGAGTT -> TTCCAGAGTTG
ATTCCCTCTTG -> TTCCCTCTTGC
ATTCCTAGGAG -> TTCCTAGGAGA
ATTCCTCATCT -> TTCCTCATCTA
ATTCCTCCAAT -> TTCCTCCAATA
ATTCTATCCCT -> TTCTATCCCTC
ATTCTGAATAC -> TTCTGAATACT
ATTGCCGGCCC -> TTGCCGGCCCC
ATTGCGTACAT -> TTGCGTACATG
ATTGCGTGGAA -> TTGCGTGGAAA
ATTGCTCGTAT -> TTGCTCGTATA
ATTGGATGAGG -> TTGGATGAGGG
ATTGGCGCGAT -> TTGGCGCGATT
ATTGGCGGCAT -> TTGGCGGCATG
ATTGGGTCAAG -> TTGGGTCAAGG
ATTGGTTCTTC -> TTGGTTCTTCC
ATTGTCATCGG -> TTGTCATCGGA
ATTGTCCACAA -> TTGTCCACAAG
ATTTCCAATGT -> TTTCCAATGTC
ATTTTGTCCAC -> TTTTGTCCACG
ATTTTTCGAAT -> TTTTTCGAATG
CAAACCGCGTT -> AAACCGCGTTG
CAAACTGACTA -> AAACTGACTAG
CAAAGTCCCGT -> AAAGTCCCGTA
CAAATAAGCTT -> AAATAAGCTTA
CAAATGCACAC -> AAATGCACACT
CAAATTCCCTC -> AAATTCCCTCT
CAACAACCGAA -> AACAACCGAAC
CAACACGGCTT -> AACACGGCTTG
CAACACTATAT -> AACACTATATA
CAACAGTGAAG -> AACAGTGAAGC
CAACCACATGC -> AACCACATGCG
CAACCGAACCA -> AACCGAACCAA
CAACGCCCGAT -> AACGCCCGATA
CAACGGGGCCG -> AACGGGGCCGA
CAAGACCAAAC -> AAGACCAAACT
CAAGCAGACTA -> AAGCAGACTAT
CAAGCGCTTGC -> AAGCGCTTGCC
CAAGGCATTTT -> AAGGCATTTTT
CAAGGCCGATT -> AAGGCCGATTG
CAAGGGAAGCA -> AAGGGAAGCAT
CAAGGTCAGGT -> AAGGTCAGGTG
CAAGTGCTGAC -> AAGTGCTGACC
CAAGTGTTAGA -> AAGTGTTAGAC
CAATACAGTAA -> AATACAGTAAT
CAATATCCGAC -> AATATCCGACT
CAATCCACCTA -> AATCCACCTAA
CAATCCCCCCT -> AATCCCCCCTA
CAATCGCCTGC -> AATCGCCTGCC
CAATCTAAATC -> AATCTAAATCC
CAATCTCGCAG -> AATCTCGCAGT
CAATGGGCCAT -> AATGGGCCATC
CAATGTCTATT -> AATGTCTATTC
CAATGTTCGAA -> AATGTTCGAAG
CAATTCAAATT -> AATTCAAATTC
CAATTCAAGGG -> AATTCAAGGGA
CACAACAGTGA -> ACAACAGTGAA
CACAAGTGTTA -> ACAAGTGTTAG
CACACTCACTG -> ACACTCACTGG
CACACTCCCGA -> ACACTCCCGAA
CACAGACGTTC -> ACAGACGTTCA
CACATCGTCAG -> ACATCGTCAGT
CACATGCGTTT -> ACATGCGTTTC
CACATTCCTAG -> ACATTCCTAGG
CACCAACCACA -> ACCAACCACAT
CACCACCTCGG -> ACCACCTCGGG
CACCACGTTGC -> ACCACGTTGCG
CACCCATAACG -> ACCCATAACGT
CACCGGACTAA -> ACCGGACTAAA
CACCTAAGCAA -> ACCTAAGCAAT
CACCTCGGGTT -> ACCTCGGGTTG
CACCTGGTCGC -> ACCTGGTCGCT
CACCTTAATCT -> ACCTTAATCTT
CACGAACAGTA -> ACGAACAGTAA
CACGCGGTCGG -> ACGCGGTCGGA
CACGGCTTGCG -> ACGGCTTGCGT
CACGGTGAGCA -> ACGGTGAGCAG
CACGGTGGGAT -> ACGGTGGGATA
CACGTTGCGCT -> ACGTTGCGCTA
CACTATATACG -> ACTATATACGA
CACTATTAAAG -> ACTATTAAAGT
CACTCACTGGA -> ACTCACTGGAA
CACTCCCGAAG -> ACTCCCGAAGA
CACTGCTCATG -> ACTGCTCATGA
CACTGGAAGGC -> ACTGGAAGGCC
CACTGTGTGAA -> ACTGTGTGAAA
CACTTATTCTG -> ACTTATTCTGA
CAGAAGGCAAC -> AGAAGGCAACA
CAGAATGCAAT -> AGAATGCAATA
CAGAATTGCTC -> AGAATTGCTCG
CAGACGTTCAA -> AGACGTTCAAG
CAGACTATACT -> AGACTATACTC
CAGAGTCGCTC -> AGAGTCGCTCA
CAGAGTTGTCG -> AGAGTTGTCGG
CAGATAGTCTT -> AGATAGTCTTA
CAGCAGGGTCT -> AGCAGGGTCTG
CAGCCATCACC -> AGCCATCACCT
CAGCCCCAATC -> AGCCCCAATCT
CAGCGTTCGTC -> AGCGTTCGTCG
CAGCTGCAAAG -> AGCTGCAAAGT
CAGGAGGATCG -> AGGAGGATCGC
CAGGCCGTACA -> AGGCCGTACAC
CAGGCTAATCT -> AGGCTAATCTA
CAGGCTAGTCG -> AGGCTAGTCGT
CAGGGAACGCT -> AGGGAACGCTG
CAGGGTCTGTT -> AGGGTCTGTTA
CAGGTGGAGCT -> AGGTGGAGCTT
CAGGTGGTGGC -> AGGTGGTGGCG
CAGGTGTCGTG -> AGGTGTCGTGT
CAGTAAGCCCC -> AGTAAGCCCCC
CAGTAAGCCTC -> AGTAAGCCTCT
CAGTAATACCC -> AGTAATACCCG
CAGTACCAATG -> AGTACCAATGG
CAGTGAAGCCT -> AGTGAAGCCTC
CAGTGGCTAAT -> AGTGGCTAATC
CAGTTACGTCA -> AGTTACGTCAT
CAGTTGCACAT -> AGTTGCACATT
CATAACGTCCC -> ATAACGTCCCC
CATAAGCACGG -> ATAAGCACGGT
CATACCCCTAA -> ATACCCCTAAG
CATATCTAATT -> ATATCTAATTG
CATCAAGACCA -> ATCAAGACCAA
CATCAATCCCC -> ATCAATCCCCC
CATCACCTGGT -> ATCACCTGGTC
CATCAGGAGGA -> ATCAGGAGGAT
CATCCAATCCA -> ATCCAATCCAC
CATCGACTGTA -> ATCGACTGTAA
CATCGAGGGGT -> ATCGAGGGGTG
CATCGCACTAT -> ATCGCACTATT
CATCGCTAAGT -> ATCGCTAAGTT
CATCGGAACCC -> ATCGGAACCCG
CATCGTCAGTT -> ATCGTCAGTTA
CATCTAGTTGG -> ATCTAGTTGGT
CATCTCGAGTA -> ATCTCGAGTAA
CATCTTCTCTC -> ATCTTCTCTCT
CATGAAGCCGT -> ATGAAGCCGTT
CATGACGTAGT -> ATGACGTAGTA
CATGATCACTG -> ATGATCACTGC
CATGCGTTTCT -> ATGCGTTTCTT
CATGGGCGCCG -> ATGGGCGCCGA
CATTACCAGAG -> ATTACCAGAGT
CATTACTCCCC -> ATTACTCCCCC
CATTATTAGCG -> ATTATTAGCGT
CATTCCTAGGA -> ATTCCTAGGAG
CATTCCTCCAA -> ATTCCTCCAAT
CATTGCGTGGA -> ATTGCGTGGAA
CATTTTTCGAA -> ATTTTTCGAAT
CCAAACCGCGT -> CAAACCGCGTT
CCAAACTGACT -> CAAACTGACTA
CCAACAACCGA -> CAACAACCGAA
CCAACCACATG -> CAACCACATGC
CCAAGCAGACT -> CAAGCAGACTA
CCAAGGCCGAT -> CAAGGCCGATT
CCAATACAGTA -> CAATACAGTAA
CCAATCCACCT -> CAATCCACCTA
CCAATCGCCTG -> CAATCGCCTGC
CCAATCTAAAT -> CAATCTAAATC
CCAATGGGCCA -> CAATGGGCCAT
CCAATGTCTAT -> CAATGTCTATT
CCACAAGTGTT -> CACAAGTGTTA
CCACATCGTCA -> CACATCGTCAG
CCACATGCGTT -> CACATGCGTTT
CCACCCATAAC -> CACCCATAACG
CCACCGGACTA -> CACCGGACTAA
CCACCTAAGCA -> CACCTAAGCAA
CCACCTCGGGT -> CACCTCGGGTT
CCACGCGGTCG -> CACGCGGTCGG
CCACGTTGCGC -> CACGTTGCGCT
CCACTGTGTGA -> CACTGTGTGAA
CCAGAGTCGCT -> CAGAGTCGCTC
CCAGAGTTGTC -> CAGAGTTGTCG
CCAGATAGTCT -> CAGATAGTCTT
CCATAACGTCC -> CATAACGTCCC
CCATCACCTGG -> CATCACCTGGT
CCATCCAATCC -> CATCCAATCCA
CCATCGAGGGG -> CATCGAGGGGT
CCATCGCTAAG -> CATCGCTAAGT
CCATCTCGAGT -> CATCTCGAGTA
CCATTACCAGA -> CATTACCAGAG
CCCAAGGCCGA -> CCAAGGCCGAT
CCCAATCTAAA -> CCAATCTAAAT
CCCAGATAGTC -> CCAGATAGTCT
CCCATAACGTC -> CCATAACGTCC
CCCATCGAGGG -> CCATCGAGGGG
CCCCAAGGCCG -> CCCAAGGCCGA
CCCCAATCTAA -> CCCAATCTAAA
CCCCATCGAGG -> CCCATCGAGGG
CCCCCCTAAAG -> CCCCCTAAAGC
CCCCCCTAATG -> CCCCCTAATGG
CCCCCTAAAGC -> CCCCTAAAGCG
CCCCCTAATGG -> CCCCTAATGGG
CCCCCTATTGC -> CCCCTATTGCG
CCCCTAAAGCG -> CCCTAAAGCGA
CCCCTAAGATA -> CCCTAAGATAC
CCCCTAATGGG -> CCCTAATGGGC
CCCCTATTGCG -> CCCTATTGCGT
CCCCTTAGAAC -> CCCTTAGAACG
CCCCTTGCCCT -> CCCTTGCCCTA
CCCGAACCGTG -> CCGAACCGTGT
CCCGAAGATTG -> CCGAAGATTGC
CCCGATATGAT -> CCGATATGATG
CCCGATTAACC -> CCGATTAACCT
CCCGCATCGCA -> CCGCATCGCAC
CCCGGGCGAGC -> CCGGGCGAGCA
CCCGTACTTAC -> CCGTACTTACT
CCCGTAGTCCT -> CCGTAGTCCTA
CCCTAAAGCGA -> CCTAAAGCGAC
CCCTAAGATAC -> CCTAAGATACG
CCCTAATGAAA -> CCTAATGAAAA
CCCTAATGGGC -> CCTAATGGGCG
CCCTAGGGTCC -> CCTAGGGTCCC
CCCTATTATGG -> CCTATTATGGC
CCCTATTGCGT -> CCTATTGCGTA
CCCTCCGGCAG -> CCTCCGGCAGC
CCCTCTTCACG -> CCTCTTCACGG
CCCTCTTGCCA -> CCTCTTGCCAT
CCCTTAGAACG -> CCTTAGAACGA
CCCTTGCCCTA -> CCTTGCCCTAT
CCGAACCAATC -> CGAACCAATCG
CCGAACCGTGT -> CGAACCGTGTA
CCGAAGATTGC -> CGAAGATTGCC
CCGACTACAAT -> CGACTACAATT
CCGACTATCCG -> CGACTATCCGT
CCGAGTCGCGC -> CGAGTCGCGCC
CCGAGTGGTTA -> CGAGTGGTTAT
CCGATATGATG -> CGATATGATGC
CCGATTAACCT -> CGATTAACCTT
CCGATTGGGTC -> CGATTGGGTCA
CCGATTGTCCA -> CGATTGTCCAC
CCGCATCGCAC -> CGCATCGCACT
CCGCCAAGCAG -> CGCCAAGCAGA
CCGCGTTGAAG -> CGCGTTGAAGC
CCGGACTAAAC -> CGGACTAAACC
CCGGCAGCCAT -> CGGCAGCCATC
CCGGCCCCTTA -> CGGCCCCTTAG
CCGGGCGAGCA -> CGGGCGAGCAG
CCGGTAGGCGG -> CGGTAGGCGGT
CCGTACACCAC -> CGTACACCACG
CCGTACTTACT -> CGTACTTACTT
CCGTAGTCCTA -> CGTAGTCCTAT
CCGTCATATCT -> CGTCATATCTA
CCGTCTTAGGG -> CGTCTTAGGGT
CCGTGGAATCA -> CGTGGAATCAC
CCGTGTATAGG -> CGTGTATAGGC
CCGTTACGTTT -> CGTTACGTTTC
CCGTTCAGCTG -> CGTTCAGCTGC
CCGTTGGGGCC -> CGTTGGGGCCT
CCTAAAGCGAC -> CTAAAGCGACA
CCTAAGATACG -> CTAAGATACGA
CCTAAGCAATC -> CTAAGCAATCT
CCTAATGAAAA -> CTAATGAAAAT
CCTAATGGGCG -> CTAATGGGCGC
CCTACAAATAA -> CTACAAATAAG
CCTAGGAGACT -> CTAGGAGACTG
CCTAGGGTCCC -> CTAGGGTCCCG
CCTATCGTGGG -> CTATCGTGGGG
CCTATTATGGC -> CTATTATGGCA
CCTATTGCGTA -> CTATTGCGTAC
CCTCAATGTTC -> CTCAATGTTCG
CCTCACGAACA -> CTCACGAACAG
CCTCATCTAGT -> CTCATCTAGTT
CCTCCAATACA -> CTCCAATACAG
CCTCCGGCAGC -> CTCCGGCAGCC
CCTCCTGGTGG -> CTCCTGGTGGT
CCTCCTTACTC -> CTCCTTACTCA
CCTCGGGTTGC -> CTCGGGTTGCT
CCTCTACCTTC -> CTCTACCTTCC
CCTCTATCCGA -> CTCTATCCGAG
CCTCTGTGCTC -> CTCTGTGCTCG
CCTCTTCACGG -> CTCTTCACGGT
CCTCTTGCCAT -> CTCTTGCCATC
CCTGCCGTCTT -> CTGCCGTCTTA
CCTGGAGACGT -> CTGGAGACGTG
CCTGGTACACA -> CTGGTACACAC
CCTGGTAGTGG -> CTGGTAGTGGG
CCTGGTCGCTT -> CTGGTCGCTTG
CCTGGTGGTAT -> CTGGTGGTATA
CCTGTCTCACT -> CTGTCTCACTT
CCTTAATCTTA -> CTTAATCTTAA
CCTTACTCAAC -> CTTACTCAACA
CCTTACTGTCC -> CTTACTGTCCC
CCTTAGAACGA -> CTTAGAACGAC
CCTTCCCGTAC -> CTTCCCGTACT
CCTTGCCCTAT -> CTTGCCCTATT
CCTTGTATTGG -> CTTGTATTGGC
CGAAACTCATG -> GAAACTCATGG
CGAACAGTAAG -> GAACAGTAAGC
CGAACCAATCG -> GAACCAATCGC
CGAACCGTGTA -> GAACCGTGTAT
CGAAGATTGCC -> GAAGATTGCCG
CGAAGGGCCTC -> GAAGGGCCTCC
CGAATGCTCTT -> GAATGCTCTTT
CGAATGGAACG -> GAATGGAACGG
CGAATTGGATG -> GAATTGGATGA
CGACAGAAGGC -> GACAGAAGGCA
CGACCCGATTA -> GACCCGATTAA
CGACTACAATT -> GACTACAATTC
CGACTACCACC -> GACTACCACCC
CGACTATCCGT -> GACTATCCGTC
CGACTGTAATC -> GACTGTAATCA
CGAGCAGGCTA -> GAGCAGGCTAG
CGAGGAAGTAT -> GAGGAAGTATA
CGAGGAGGAAT -> GAGGAGGAATA
CGAGGGGTGGA -> GAGGGGTGGAG
CGAGTAAACAT -> GAGTAAACATT
CGAGTCGCGCC -> GAGTCGCGCCA
CGAGTGGTTAT -> GAGTGGTTATA
CGATAGGTCAG -> GATAGGTCAGG
CGATATGATGC -> GATATGATGCT
CGATGAGTACC -> GATGAGTACCG
CGATTAACCTT -> GATTAACCTTG
CGATTGGGTCA -> GATTGGGTCAA
CGATTGTCCAC -> GATTGTCCACA
CGATTTCCAAT -> GATTTCCAATG
CGCACTATTAA -> GCACTATTAAA
CGCAGGCCGTA -> GCAGGCCGTAC
CGCAGTAAGCC -> GCAGTAAGCCT
CGCATCGCACT -> GCATCGCACTA
CGCCAACAACC -> GCCAACAACCG
CGCCAAGCAGA -> GCCAAGCAGAC
CGCCACTGTGT -> GCCACTGTGTG
CGCCCGATATG -> GCCCGATATGA
CGCCGACTATC -> GCCGACTATCC
CGCCTCTATCC -> GCCTCTATCCG
CGCCTGCCGTC -> GCCTGCCGTCT
CGCGACTACCA -> GCGACTACCAC
CGCGATTTCCA -> GCGATTTCCAA
CGCGCCAACAA -> GCGCCAACAAC
CGCGCGACTAC -> GCGCGACTACC
CGCGCTGTCCT -> GCGCTGTCCTT
CGCGGTCGGAA -> GCGGTCGGAAT
CGCGTTGAAGC -> GCGTTGAAGCG
CGCTAAGTTAG -> GCTAAGTTAGC
CGCTATTAAGT -> GCTATTAAGTG
CGCTCACCAAC -> GCTCACCAACC
CGCTGAAGCGG -> GCTGAAGCGGA
CGCTGTCCTTA -> GCTGTCCTTAC
CGCTTGCCGTT -> GCTTGCCGTTA
CGCTTGTTTAG -> GCTTGTTTAGG
CGGAACCCGGG -> GGAACCCGGGC
CGGAATAACCC -> GGAATAACCCT
CGGACTAAACC -> GGACTAAACCA
CGGATACTTCC -> GGATACTTCCT
CGGCAGCCATC -> GGCAGCCATCA
CGGCATGACGT -> GGCATGACGTA
CGGCCCCTTAG -> GGCCCCTTAGA
CGGCCGTGGAA -> GGCCGTGGAAT
CGGCGTATGAA -> GGCGTATGAAA
CGGCTTGCGTC -> GGCTTGCGTCT
CGGGCGAGCAG -> GGGCGAGCAGG
CGGGGCCGATT -> GGGGCCGATTG
CGGGTTGCTAA -> GGGTTGCTAAC
CGGTAGACCAA -> GGTAGACCAAA
CGGTAGGCGGT -> GGTAGGCGGTA
CGGTATAGGGG -> GGTATAGGGGA
CGGTCATTCCT -> GGTCATTCCTC
CGGTCGGAATA -> GGTCGGAATAA
CGGTGAGCAGG -> GGTGAGCAGGG
CGGTGGGATAC -> GGTGGGATACA
CGTACACCACG -> GTACACCACGT
CGTACATGATC -> GTACATGATCA
CGTACCACCGG -> GTACCACCGGA
CGTACTTACTT -> GTACTTACTTC
CGTAGTAATTA -> GTAGTAATTAC
CGTAGTCCTAT -> GTAGTCCTATC
CGTATAGCAGC -> GTATAGCAGCA
CGTATGAAATC -> GTATGAAATCG
CGTCAGTTACG -> GTCAGTTACGT
CGTCATATCTA -> GTCATATCTAA
CGTCATCAAGA -> GTCATCAAGAC
CGTCCCCAAGG -> GTCCCCAAGGC
CGTCGTGTAAT -> GTCGTGTAATT
CGTCTGTCAGA -> GTCTGTCAGAA
CGTCTGTGATC -> GTCTGTGATCT
CGTCTTAGGGT -> GTCTTAGGGTA
CGTGAGGCTGT -> GTGAGGCTGTG
CGTGGAAATTG -> GTGGAAATTGG
CGTGGAATCAC -> GTGGAATCACC
CGTGGGGTTCC -> GTGGGGTTCCT
CGTGGTGGTGA -> GTGGTGGTGAC
CGTGTAATTCC -> GTGTAATTCCT
CGTGTATAGGC -> GTGTATAGGCT
CGTGTCCCTAA -> GTGTCCCTAAT
CGTGTGGTATT -> GTGTGGTATTG
CGTTACGTTTC -> GTTACGTTTCA
CGTTCAAGGTC -> GTTCAAGGTCA
CGTTCAGCTGC -> GTTCAGCTGCA
CGTTCGTCGTG -> GTTCGTCGTGT
CGTTGAAGCGG -> GTTGAAGCGGT
CGTTGCGCTAT -> GTTGCGCTATT
CGTTGGGGCCT -> GTTGGGGCCTC
CGTTTCATACC -> GTTTCATACCC
CGTTTCGGTCA -> GTTTCGGTCAT
CGTTTCTTAGA -> GTTTCTTAGAG
CTAAACCATTA -> TAAACCATTAC
CTAAAGCGACA -> TAAAGCGACAG
CTAAATCCGCC -> TAAATCCGCCA
CTAACCCCATC -> TAACCCCATCG
CTAAGATACGA -> TAAGATACGAG
CTAAGCAATCT -> TAAGCAATCTC
CTAAGTTAGCT -> TAAGTTAGCTG
CTAATCTAGGT -> TAATCTAGGTA
CTAATCTCAGG -> TAATCTCAGGT
CTAATGAAAAT -> TAATGAAAATC
CTAATGGGCGC -> TAATGGGCGCA
CTAATTGGCGC -> TAATTGGCGCG
CTACAAATAAG -> TACAAATAAGC
CTACAATTCAA -> TACAATTCAAA,TACAATTCAAG
CTACCACCCAT -> TACCACCCATA
CTACCTTCCCG -> TACCTTCCCGT
CTACGTACCAC -> TACGTACCACC
CTAGAATCCCC -> TAGAATCCCCT
CTAGCAGCGTT -> TAGCAGCGTTC
CTAGCATTACT -> TAGCATTACTC
CTAGGAGACTG -> TAGGAGACTGA
CTAGGGTCCCG -> TAGGGTCCCGA
CTAGGTAGGTG -> TAGGTAGGTGG
CTAGTCGTCTG -> TAGTCGTCTGT
CTAGTTAGTAT -> TAGTTAGTATT
CTAGTTGGTTG -> TAGTTGGTTGT
CTATACTCACA -> TATACTCACAG
CTATATACGAT -> TATATACGATA
CTATCCCTCCG -> TATCCCTCCGG
CTATCCGAGTC -> TATCCGAGTCG
CTATCCGTCAT -> TATCCGTCATA
CTATCGTGGGG -> TATCGTGGGGT
CTATTAAAGTC -> TATTAAAGTCG
CTATTAAGTGA -> TATTAAGTGAG
CTATTATGGCA -> TATTATGGCAT
CTATTCTATCC -> TATTCTATCCC
CTATTGCGTAC -> TATTGCGTACA
CTCAACACTAT -> TCAACACTATA
CTCAAGCGCTT -> TCAAGCGCTTG
CTCAATGTTCG -> TCAATGTTCGA
CTCACAGACGT -> TCACAGACGTT
CTCACCAACCA -> TCACCAACCAC
CTCACGAACAG -> TCACGAACAGT
CTCACTGGAAG -> TCACTGGAAGG
CTCACTTATTC -> TCACTTATTCT
CTCAGGTGGAG -> TCAGGTGGAGC
CTCATCTAGTT -> TCATCTAGTTG
CTCATGAAGCC -> TCATGAAGCCG
CTCATGGGCGC -> TCATGGGCGCC
CTCCAATACAG -> TCCAATACAGT
CTCCCCCTATT -> TCCCCCTATTG
CTCCCGAAGAT -> TCCCGAAGATT
CTCCGGCAGCC -> TCCGGCAGCCA
CTCCTGGTGGT -> TCCTGGTGGTA
CTCCTTACTCA -> TCCTTACTCAA
CTCGAGTAAAC -> TCGAGTAAACA
CTCGCAGTAAG -> TCGCAGTAAGC
CTCGGGTTGCT -> TCGGGTTGCTA
CTCGTATAGCA -> TCGTATAGCAG
CTCGTTTCGGT -> TCGTTTCGGTC
CTCTACCTTCC -> TCTACCTTCCC
CTCTAGCAGCG -> TCTAGCAGCGT
CTCTATCCGAG -> TCTATCCGAGT
CTCTCAAGCGC -> TCTCAAGCGCT
CTCTCTAGCAG -> TCTCTAGCAGC
CTCTGTGCTCG -> TCTGTGCTCGT
CTCTTCACGGT -> TCTTCACGGTG
CTCTTGCCATC -> TCTTGCCATCG
CTCTTTCATCG -> TCTTTCATCGA
CTGAAGCGGAT -> TGAAGCGGATA
CTGAATACTAC -> TGAATACTACA
CTGAATATGGG -> TGAATATGGGT
CTGACCTCCTT -> TGACCTCCTTA
CTGACTAGTTA -> TGACTAGTTAG
CTGACTGTGAA -> TGACTGTGAAA
CTGAGGAGTGC -> TGAGGAGTGCA
CTGATATATCG -> TGATATATCGA
CTGCAAAGTCC -> TGCAAAGTCCC
CTGCCGTCTTA -> TGCCGTCTTAG
CTGCTCATGAA -> TGCTCATGAAG
CTGGAAGGCCT -> TGGAAGGCCTG
CTGGAGACGTG -> TGGAGACGTGA
CTGGAGTCATA -> TGGAGTCATAA
CTGGGCAGTGG -> TGGGCAGTGGC
CTGGTACACAC -> TGGTACACACT
CTGGTAGTGGG -> TGGTAGTGGGC
CTGGTCGCTTG -> TGGTCGCTTGT
CTGGTGGTATA -> TGGTGGTATAG
CTGTAATCATC -> TGTAATCATCA
CTGTAGGCTGA -> TGTAGGCTGAC
CTGTATGCTCT -> TGTATGCTCTC
CTGTCAGAATG -> TGTCAGAATGC
CTGTCCCAGAT -> TGTCCCAGATA
CTGTCCTTACT -> TGTCCTTACTG
CTGTCTCACTT -> TGTCTCACTTA
CTGTGAAAATA -> TGTGAAAATAT
CTGTGATCTTA -> TGTGATCTTAA
CTGTGCTCGTT -> TGTGCTCGTTT
CTGTGGTCCTA -> TGTGGTCCTAC
CTGTGTGAAAG -> TGTGTGAAAGG
CTGTTAACCAT -> TGTTAACCATC
CTTAACAACGG -> TTAACAACGGG
CTTAAGCCGAG -> TTAAGCCGAGT
CTTAAGGCAGT -> TTAAGGCAGTA
CTTAATCTTAA -> TTAATCTTAAG
CTTACTAGAAT -> TTACTAGAATC
CTTACTCAACA -> TTACTCAACAC
CTTACTGTCCC -> TTACTGTCCCA
CTTACTTCTTA -> TTACTTCTTAA
CTTAGAACGAC -> TTAGAACGACC
CTTAGAGGTAC -> TTAGAGGTACG
CTTAGGGTATG -> TTAGGGTATGA
CTTATTCTGAA -> TTATTCTGAAT
CTTCACGGTGA -> TTCACGGTGAG
CTTCCCGTACT -> TTCCCGTACTT
CTTCCCTAGGG -> TTCCCTAGGGT
CTTCCTCAATG -> TTCCTCAATGT
CTTCTCTCTAG -> TTCTCTCTAGC
CTTCTTAAGGC -> TTCTTAAGGCA
CTTGCCATCGC -> TTGCCATCGCT
CTTGCCCTATT -> TTGCCCTATTA
CTTGCCGTTAC -> TTGCCGTTACG
CTTGCGTCTGT -> TTGCGTCTGTC
CTTGTATTGGC -> TTGTATTGGCG
CTTGTTTAGGA -> TTGTTTAGGAA
CTTTCATCGAC -> TTTCATCGACT
CTTTTCAACGC -> TTTTCAACGCC
GAAAATATTAA -> AAAATATTAAG
GAAAATCCGTT -> AAAATCCGTTC
GAAACTCATGG -> AAACTCATGGG
GAAAGGTGAAC -> AAAGGTGAACA
GAAATCGTGTC -> AAATCGTGTCC
GAAATTGGTTC -> AAATTGGTTCT
GAACACCTTAA -> AACACCTTAAT
GAACAGTAAGC -> AACAGTAAGCC
GAACCAATCGC -> AACCAATCGCC
GAACCCGGGCG -> AACCCGGGCGA
GAACCGTGTAT -> AACCGTGTATA
GAACGACCCGA -> AACGACCCGAT
GAACGCTGAAG -> AACGCTGAAGC
GAACGGCGTAT -> AACGGCGTATG
GAAGAGTAGCC -> AAGAGTAGCCT
GAAGATTGCCG -> AAGATTGCCGG
GAAGCATTGCG -> AAGCATTGCGT
GAAGCCGTTGG -> AAGCCGTTGGG
GAAGCCTCACG -> AAGCCTCACGA
GAAGCGGATAC -> AAGCGGATACT
GAAGCGGTATA -> AAGCGGTATAG
GAAGGCAACAC -> AAGGCAACACG
GAAGGCCTGTC -> AAGGCCTGTCT
GAAGGCGAGGA -> AAGGCGAGGAG
GAAGGGCCTCC -> AAGGGCCTCCT
GAAGTATAAGT -> AAGTATAAGTT
GAATAAAATAG -> AATAAAATAGT
GAATAACCCTC -> AATAACCCTCT
GAATAATTCAA -> AATAATTCAAA
GAATACTACAA -> AATACTACAAT
GAATATGGGTT -> AATATGGGTTG
GAATCACCACC -> AATCACCACCT
GAATCCCCTTG -> AATCCCCTTGC
GAATGCAATAT -> AATGCAATATC
GAATGCTCTTT -> AATGCTCTTTC
GAATGGAACGG -> AATGGAACGGC
GAATGGAGAGA -> AATGGAGAGAA
GAATTGCTCGT -> AATTGCTCGTA
GAATTGGATGA -> AATTGGATGAG
GACAGAAGGCA -> ACAGAAGGCAA
GACAGCCCCAA -> ACAGCCCCAAT
GACAGGCTAAT -> ACAGGCTAATC
GACAGTTGCAC -> ACAGTTGCACA
GACCAAACCGC -> ACCAAACCGCG
GACCAAACTGA -> ACCAAACTGAC
GACCCGATTAA -> ACCCGATTAAC
GACCTCCTTAC -> ACCTCCTTACT
GACGTAGTAAT -> ACGTAGTAATT
GACGTGAGGCT -> ACGTGAGGCTG
GACGTTCAAGG -> ACGTTCAAGGT
GACTAAACCAT -> ACTAAACCATT
GACTACAATTC -> ACTACAATTCA
GACTACCACCC -> ACTACCACCCA
GACTAGTTAGT -> ACTAGTTAGTA
GACTATACTCA -> ACTATACTCAC
GACTATCCGTC -> ACTATCCGTCA
GACTGATATAT -> ACTGATATATC
GACTGTAATCA -> ACTGTAATCAT
GACTGTGAAAA -> ACTGTGAAAAT
GAGAAGAGTAG -> AGAAGAGTAGC
GAGACGTGAGG -> AGACGTGAGGC
GAGACTGATAT -> AGACTGATATA
GAGAGAAGAGT -> AGAGAAGAGTA
GAGCAGGCTAG -> AGCAGGCTAGT
GAGCAGGGAAC -> AGCAGGGAACG
GAGCTGAGGAG -> AGCTGAGGAGT
GAGCTTTTCAA -> AGCTTTTCAAC
GAGGAAGTATA -> AGGAAGTATAA
GAGGAATAATT -> AGGAATAATTC
GAGGAGGAATA -> AGGAGGAATAA
GAGGAGTGCAA -> AGGAGTGCAAG
GAGGATCGCGC -> AGGATCGCGCG
GAGGCTGTGGT -> AGGCTGTGGTC
GAGGGAAGGCG -> AGGGAAGGCGA
GAGGGGTGGAG -> AGGGGTGGAGT
GAGGTACGAAT -> AGGTACGAATT
GAGTAAACATT -> AGTAAACATTA
GAGTACCGGTA -> AGTACCGGTAG
GAGTAGCCTGG -> AGTAGCCTGGA
GAGTCATAAGC -> AGTCATAAGCA
GAGTCGCGCCA -> AGTCGCGCCAA
GAGTCGCTCAC -> AGTCGCTCACC
GAGTGCAAGTG -> AGTGCAAGTGC
GAGTGGTTATA -> AGTGGTTATAT
GAGTTGTCGGC -> AGTTGTCGGCC
GAGTTGTTAAT -> AGTTGTTAATA
GAGTTTCAGAA -> AGTTTCAGAAT
GATACATCTTC -> ATACATCTTCT
GATACGAGGAA -> ATACGAGGAAG
GATACTTCCTC -> ATACTTCCTCA
GATAGGTCAGG -> ATAGGTCAGGT
GATAGTCTTAC -> ATAGTCTTACT
GATATATCGAA -> ATATATCGAAA
GATATGATGCT -> ATATGATGCTA
GATCACTGCTC -> ATCACTGCTCA
GATCGCGCGAC -> ATCGCGCGACT
GATCTAGCATT -> ATCTAGCATTA
GATCTTAACAA -> ATCTTAACAAC
GATGAGGGAAG -> ATGAGGGAAGG
GATGAGTACCG -> ATGAGTACCGG
GATGCACAACA -> ATGCACAACAG
GATGCTACGTA -> ATGCTACGTAC
GATTAACCTTG -> ATTAACCTTGT
GATTGCCGGCC -> ATTGCCGGCCC
GATTGGGTCAA -> ATTGGGTCAAG
GATTGTCCACA -> ATTGTCCACAA
GATTTCCAATG -> ATTTCCAATGT
GATTTTGTCCA -> ATTTTGTCCAC
GCAAAGTCCCG -> CAAAGTCCCGT
GCAACACGGCT -> CAACACGGCTT
GCAAGTGCTGA -> CAAGTGCTGAC
GCAATATCCGA -> CAATATCCGAC
GCAATCTCGCA -> CAATCTCGCAG
GCACAACAGTG -> CACAACAGTGA
GCACACTCACT -> CACACTCACTG
GCACATTCCTA -> CACATTCCTAG
GCACGGTGGGA -> CACGGTGGGAT
GCACTATTAAA -> CACTATTAAAG
GCAGACTATAC -> CAGACTATACT
GCAGCAGGGTC -> CAGCAGGGTCT
GCAGCCATCAC -> CAGCCATCACC
GCAGCGTTCGT -> CAGCGTTCGTC
GCAGGCCGTAC -> CAGGCCGTACA
GCAGGCTAGTC -> CAGGCTAGTCG
GCAGGGAACGC -> CAGGGAACGCT
GCAGGGTCTGT -> CAGGGTCTGTT
GCAGTAAGCCT -> CAGTAAGCCTC
GCAGTACCAAT -> CAGTACCAATG
GCAGTGGCTAA -> CAGTGGCTAAT
GCATCAGGAGG -> CATCAGGAGGA
GCATCGCACTA -> CATCGCACTAT
GCATGACGTAG -> CATGACGTAGT
GCATTACTCCC -> CATTACTCCCC
GCATTGCGTGG -> CATTGCGTGGA
GCATTTTTCGA -> CATTTTTCGAA
GCCAACAACCG -> CCAACAACCGA
GCCAAGCAGAC -> CCAAGCAGACT
GCCACATCGTC -> CCACATCGTCA
GCCACTGTGTG -> CCACTGTGTGA
GCCATCACCTG -> CCATCACCTGG
GCCATCGCTAA -> CCATCGCTAAG
GCCATCTCGAG -> CCATCTCGAGT
GCCCCAATCTA -> CCCCAATCTAA
GCCCCCCTAAA -> CCCCCCTAAAG
GCCCCTTAGAA -> CCCCTTAGAAC
GCCCGATATGA -> CCCGATATGAT
GCCCTATTATG -> CCCTATTATGG
GCCGACTATCC -> CCGACTATCCG
GCCGAGTGGTT -> CCGAGTGGTTA
GCCGATTGGGT -> CCGATTGGGTC
GCCGATTGTCC -> CCGATTGTCCA
GCCGGCCCCTT -> CCGGCCCCTTA
GCCGTACACCA -> CCGTACACCAC
GCCGTCTTAGG -> CCGTCTTAGGG
GCCGTGGAATC -> CCGTGGAATCA
GCCGTTACGTT -> CCGTTACGTTT
GCCGTTGGGGC -> CCGTTGGGGCC
GCCTCACGAAC -> CCTCACGAACA
GCCTCCTGGTG -> CCTCCTGGTGG
GCCTCTACCTT -> CCTCTACCTTC
GCCTCTATCCG -> CCTCTATCCGA
GCCTCTGTGCT -> CCTCTGTGCTC
GCCTGCCGTCT -> CCTGCCGTCTT
GCCTGGAGACG -> CCTGGAGACGT
GCCTGTCTCAC -> CCTGTCTCACT
GCGACAGAAGG -> CGACAGAAGGC
GCGACTACCAC -> CGACTACCACC
GCGAGCAGGCT -> CGAGCAGGCTA
GCGAGGAGGAA -> CGAGGAGGAAT
GCGATGAGTAC -> CGATGAGTACC
GCGATTTCCAA -> CGATTTCCAAT
GCGCAGGCCGT -> CGCAGGCCGTA
GCGCCAACAAC -> CGCCAACAACC
GCGCCACTGTG -> CGCCACTGTGT
GCGCCGACTAT -> CGCCGACTATC
GCGCGACTACC -> CGCGACTACCA
GCGCGATTTCC -> CGCGATTTCCA
GCGCGCTGTCC -> CGCGCTGTCCT
GCGCTATTAAG -> CGCTATTAAGT
GCGCTGTCCTT -> CGCTGTCCTTA
GCGCTTGCCGT -> CGCTTGCCGTT
GCGGATACTTC -> CGGATACTTCC
GCGGCATGACG -> CGGCATGACGT
GCGGTAGACCA -> CGGTAGACCAA
GCGGTATAGGG -> CGGTATAGGGG
GCGGTCGGAAT -> CGGTCGGAATA
GCGTACATGAT -> CGTACATGATC
GCGTATGAAAT -> CGTATGAAATC
GCGTCTGTCAG -> CGTCTGTCAGA
GCGTGGAAATT -> CGTGGAAATTG
GCGTGGTGGTG -> CGTGGTGGTGA
GCGTTCGTCGT -> CGTTCGTCGTG
GCGTTGAAGCG -> CGTTGAAGCGG
GCGTTTCTTAG -> CGTTTCTTAGA
GCTAACCCCAT -> CTAACCCCATC
GCTAAGTTAGC -> CTAAGTTAGCT
GCTAATCTAGG -> CTAATCTAGGT
GCTAATCTCAG -> CTAATCTCAGG
GCTACGTACCA -> CTACGTACCAC
GCTAGTCGTCT -> CTAGTCGTCTG
GCTATTAAGTG -> CTATTAAGTGA
GCTCACCAACC -> CTCACCAACCA
GCTCATGAAGC -> CTCATGAAGCC
GCTCGTATAGC -> CTCGTATAGCA
GCTCGTTTCGG -> CTCGTTTCGGT
GCTCTCAAGCG -> CTCTCAAGCGC
GCTCTTTCATC -> CTCTTTCATCG
GCTGAAGCGGA -> CTGAAGCGGAT
GCTGAATATGG -> CTGAATATGGG
GCTGACCTCCT -> CTGACCTCCTT
GCTGACTGTGA -> CTGACTGTGAA
GCTGAGGAGTG -> CTGAGGAGTGC
GCTGCAAAGTC -> CTGCAAAGTCC
GCTGGGCAGTG -> CTGGGCAGTGG
GCTGTCCTTAC -> CTGTCCTTACT
GCTGTGGTCCT -> CTGTGGTCCTA
GCTTGCCGTTA -> CTTGCCGTTAC
GCTTGCGTCTG -> CTTGCGTCTGT
GCTTGTTTAGG -> CTTGTTTAGGA
GCTTTTCAACG -> CTTTTCAACGC
GGAAATTGGTT -> GAAATTGGTTC
GGAACCCGGGC -> GAACCCGGGCG
GGAACGCTGAA -> GAACGCTGAAG
GGAACGGCGTA -> GAACGGCGTAT
GGAAGCATTGC -> GAAGCATTGCG
GGAAGGCCTGT -> GAAGGCCTGTC
GGAAGGCGAGG -> GAAGGCGAGGA
GGAAGTATAAG -> GAAGTATAAGT
GGAATAAAATA -> GAATAAAATAG
GGAATAACCCT -> GAATAACCCTC
GGAATAATTCA -> GAATAATTCAA
GGAATCACCAC -> GAATCACCACC
GGACTAAACCA -> GACTAAACCAT
GGAGACGTGAG -> GAGACGTGAGG
GGAGACTGATA -> GAGACTGATAT
GGAGAGAAGAG -> GAGAGAAGAGT
GGAGCTGAGGA -> GAGCTGAGGAG
GGAGCTTTTCA -> GAGCTTTTCAA
GGAGGAATAAT -> GAGGAATAATT
GGAGGATCGCG -> GAGGATCGCGC
GGAGTCATAAG -> GAGTCATAAGC
GGAGTGCAAGT -> GAGTGCAAGTG
GGAGTTTCAGA -> GAGTTTCAGAA
GGATACATCTT -> GATACATCTTC
GGATACTTCCT -> GATACTTCCTC
GGATCGCGCGA -> GATCGCGCGAC
GGATGAGGGAA -> GATGAGGGAAG
GGATTTTGTCC -> GATTTTGTCCA
GGCAACACGGC -> GCAACACGGCT
GGCAGCCATCA -> GCAGCCATCAC
GGCAGTACCAA -> GCAGTACCAAT
GGCAGTGGCTA -> GCAGTGGCTAA
GGCATCAGGAG -> GCATCAGGAGG
GGCATGACGTA -> GCATGACGTAG
GGCATTTTTCG -> GCATTTTTCGA
GGCCACATCGT -> GCCACATCGTC
GGCCATCTCGA -> GCCATCTCGAG
GGCCCCTTAGA -> GCCCCTTAGAA
GGCCGATTGGG -> GCCGATTGGGT
GGCCGATTGTC -> GCCGATTGTCC
GGCCGTACACC -> GCCGTACACCA
GGCCGTGGAAT -> GCCGTGGAATC
GGCCTCCTGGT -> GCCTCCTGGTG
GGCCTCTGTGC -> GCCTCTGTGCT
GGCCTGTCTCA -> GCCTGTCTCAC
GGCGAGCAGGC -> GCGAGCAGGCT
GGCGAGGAGGA -> GCGAGGAGGAA
GGCGATGAGTA -> GCGATGAGTAC
GGCGCAGGCCG -> GCGCAGGCCGT
GGCGCCGACTA -> GCGCCGACTAT
GGCGCGATTTC -> GCGCGATTTCC
GGCGCGCTGTC -> GCGCGCTGTCC
GGCGGCATGAC -> GCGGCATGACG
GGCGGTAGACC -> GCGGTAGACCA
GGCGTATGAAA -> GCGTATGAAAT
GGCTAATCTAG -> GCTAATCTAGG
GGCTAATCTCA -> GCTAATCTCAG
GGCTAGTCGTC -> GCTAGTCGTCT
GGCTGAATATG -> GCTGAATATGG
GGCTGACTGTG -> GCTGACTGTGA
GGCTGTGGTCC -> GCTGTGGTCCT
GGCTTGCGTCT -> GCTTGCGTCTG
GGGAACGCTGA -> GGAACGCTGAA
GGGAAGCATTG -> GGAAGCATTGC
GGGAAGGCGAG -> GGAAGGCGAGG
GGGATACATCT -> GGATACATCTT
GGGATTTTGTC -> GGATTTTGTCC
GGGCAGTGGCT -> GGCAGTGGCTA
GGGCCATCTCG -> GGCCATCTCGA
GGGCCGATTGT -> GGCCGATTGTC
GGGCCTCCTGG -> GGCCTCCTGGT
GGGCCTCTGTG -> GGCCTCTGTGC
GGGCGAGCAGG -> GGCGAGCAGGC
GGGCGATGAGT -> GGCGATGAGTA
GGGCGCAGGCC -> GGCGCAGGCCG
GGGCGCCGACT -> GGCGCCGACTA
GGGGATTTTGT -> GGGATTTTGTC
GGGGCCGATTG -> GGGCCGATTGT
GGGGCCTCTGT -> GGGCCTCTGTG
GGGGTGGAGTT -> GGGTGGAGTTT
GGGGTTCCTGG -> GGGTTCCTGGT
GGGTATGATGC -> GGTATGATGCA
GGGTCAAGGCA -> GGTCAAGGCAT
GGGTCCCGAAC -> GGTCCCGAACC
GGGTCTGTTAA -> GGTCTGTTAAC
GGGTGGAGTTT -> GGTGGAGTTTC
GGGTTCCTGGT -> GGTTCCTGGTA
GGGTTGCGCCA -> GGTTGCGCCAC
GGGTTGCTAAC -> GGTTGCTAACC
GGTACACACTC -> GTACACACTCC
GGTACGAATTG -> GTACGAATTGG
GGTAGACCAAA -> GTAGACCAAAC
GGTAGGCGGTA -> GTAGGCGGTAG
GGTAGGTGGAG -> GTAGGTGGAGC
GGTAGTGGGCG -> GTAGTGGGCGA
GGTATAGACAG -> GTATAGACAGC
GGTATAGGGGA -> GTATAGGGGAT
GGTATGATGCA -> GTATGATGCAC
GGTATTGTCAT -> GTATTGTCATC
GGTCAAGGCAT -> GTCAAGGCATT
GGTCAGGTGGT -> GTCAGGTGGTG
GGTCAGGTGTC -> GTCAGGTGTCG
GGTCATTCCTC -> GTCATTCCTCC
GGTCCCGAACC -> GTCCCGAACCG
GGTCCTACAAA -> GTCCTACAAAT
GGTCGCTTGTT -> GTCGCTTGTTT
GGTCGGAATAA -> GTCGGAATAAC
GGTCTGTTAAC -> GTCTGTTAACC
GGTGAACACCT -> GTGAACACCTT
GGTGACAGGCT -> GTGACAGGCTA
GGTGAGCAGGG -> GTGAGCAGGGA
GGTGGAGCTGA -> GTGGAGCTGAG
GGTGGAGCTTT -> GTGGAGCTTTT
GGTGGAGTTTC -> GTGGAGTTTCA
GGTGGCGCGCT -> GTGGCGCGCTG
GGTGGGATACA -> GTGGGATACAT
GGTGGTATAGA -> GTGGTATAGAC
GGTGGTGACAG -> GTGGTGACAGG
GGTGGTGGCGC -> GTGGTGGCGCG
GGTGTCGTGTG -> GTGTCGTGTGG
GGTTATATCTG -> GTTATATCTGT
GGTTCCTGGTA -> GTTCCTGGTAC
GGTTCTTCCCT -> GTTCTTCCCTA
GGTTGCGCCAC -> GTTGCGCCACT
GGTTGCTAACC -> GTTGCTAACCC
GGTTGTAAACG -> GTTGTAAACGC
GTAAACATTAT -> TAAACATTATT
GTAAACGCCTC -> TAAACGCCTCT
GTAAGCCCCCC -> TAAGCCCCCCT
GTAAGCCTCTA -> TAAGCCTCTAC
GTAATACCCGC -> TAATACCCGCA
GTAATCATCAA -> TAATCATCAAT
GTAATTACCTG -> TAATTACCTGG
GTAATTCCTCA -> TAATTCCTCAT
GTACACACTCC -> TACACACTCCC
GTACACCACGT -> TACACCACGTT
GTACATGATCA -> TACATGATCAC
GTACCAATGGG -> TACCAATGGGC
GTACCACCGGA -> TACCACCGGAC
GTACCGGTAGG -> TACCGGTAGGC
GTACGAATTGG -> TACGAATTGGA
GTACTTACTTC -> TACTTACTTCT
GTAGACCAAAC -> TAGACCAAACC
GTAGCCTGGAG -> TAGCCTGGAGA
GTAGGCGGTAG -> TAGGCGGTAGA
GTAGGCTGACT -> TAGGCTGACTG
GTAGGTGGAGC -> TAGGTGGAGCT
GTAGTAATTAC -> TAGTAATTACC
GTAGTCCTATC -> TAGTCCTATCG
GTAGTGGGCGA -> TAGTGGGCGAT
GTATAAGTTCT -> TATAAGTTCTG
GTATAGACAGC -> TATAGACAGCC
GTATAGCAGCA -> TATAGCAGCAG
GTATAGGCTGA -> TATAGGCTGAA
GTATAGGGGAT -> TATAGGGGATT
GTATGAAATCG -> TATGAAATCGT
GTATGATGCAC -> TATGATGCACA
GTATGCTCTCA -> TATGCTCTCAA
GTATTCCAGAG -> TATTCCAGAGT
GTATTGGCGGC -> TATTGGCGGCA
GTATTGTCATC -> TATTGTCATCG
GTCAAGGCATT -> TCAAGGCATTT
GTCAGAATGCA -> TCAGAATGCAA
GTCAGGTGGTG -> TCAGGTGGTGG
GTCAGGTGTCG -> TCAGGTGTCGT
GTCAGTTACGT -> TCAGTTACGTC
GTCATAAGCAC -> TCATAAGCACG
GTCATATCTAA -> TCATATCTAAT
GTCATCAAGAC -> TCATCAAGACC
GTCATCGGAAC -> TCATCGGAACC
GTCATTCCTCC -> TCATTCCTCCA
GTCCACAAGTG -> TCCACAAGTGT
GTCCACGCGGT -> TCCACGCGGTC
GTCCCAGATAG -> TCCCAGATAGT
GTCCCCAAGGC -> TCCCCAAGGCC
GTCCCGAACCG -> TCCCGAACCGT
GTCCCGTAGTC -> TCCCGTAGTCC
GTCCCTAATGA -> TCCCTAATGAA
GTCCTACAAAT -> TCCTACAAATA
GTCCTATCGTG -> TCCTATCGTGG
GTCCTTACTGT -> TCCTTACTGTC
GTCGAATGCTC -> TCGAATGCTCT
GTCGCGCCAAC -> TCGCGCCAACA
GTCGCTCACCA -> TCGCTCACCAA
GTCGCTTGTTT -> TCGCTTGTTTA
GTCGGAATAAC -> TCGGAATAACC
GTCGGCCGTGG -> TCGGCCGTGGA
GTCGTCTGTGA -> TCGTCTGTGAT
GTCGTGTAATT -> TCGTGTAATTC
GTCGTGTGGTA -> TCGTGTGGTAT
GTCTATTCTAT -> TCTATTCTATC
GTCTCACTTAT -> TCTCACTTATT
GTCTGTCAGAA -> TCTGTCAGAAT
GTCTGTGATCT -> TCTGTGATCTT
GTCTGTTAACC -> TCTGTTAACCA
GTCTTACTAGA -> TCTTACTAGAA
GTCTTAGGGTA -> TCTTAGGGTAT
GTGAAAATATT -> TGAAAATATTA
GTGAAAGGTGA -> TGAAAGGTGAA
GTGAACACCTT -> TGAACACCTTA
GTGAAGCCTCA -> TGAAGCCTCAC
GTGACAGGCTA -> TGACAGGCTAA
GTGAGCAGGGA -> TGAGCAGGGAA
GTGAGGCTGTG -> TGAGGCTGTGG
GTGAGTTGTTA -> TGAGTTGTTAA
GTGATCTAGCA -> TGATCTAGCAT
GTGATCTTAAC -> TGATCTTAACA
GTGCAAGTGCT -> TGCAAGTGCTG
GTGCTCGTTTC -> TGCTCGTTTCG
GTGCTGACCTC -> TGCTGACCTCC
GTGGAAATTGG -> TGGAAATTGGT
GTGGAATCACC -> TGGAATCACCA
GTGGAGCTGAG -> TGGAGCTGAGG
GTGGAGCTTTT -> TGGAGCTTTTC
GTGGAGTTTCA -> TGGAGTTTCAG
GTGGCGCGCTG -> TGGCGCGCTGT
GTGGCTAATCT -> TGGCTAATCTC
GTGGGATACAT -> TGGGATACATC
GTGGGCGATGA -> TGGGCGATGAG
GTGGGGTTCCT -> TGGGGTTCCTG
GTGGTATAGAC -> TGGTATAGACA
GTGGTATTGTC -> TGGTATTGTCA
GTGGTCCTACA -> TGGTCCTACAA
GTGGTGACAGG -> TGGTGACAGGC
GTGGTGGCGCG -> TGGTGGCGCGC
GTGGTGGTGAC -> TGGTGGTGACA
GTGGTTATATC -> TGGTTATATCT
GTGTAATTCCT -> TGTAATTCCTC
GTGTATAGGCT -> TGTATAGGCTG
GTGTCCCTAAT -> TGTCCCTAATG
GTGTCGTGTGG -> TGTCGTGTGGT
GTGTGAAAGGT -> TGTGAAAGGTG
GTGTGGTATTG -> TGTGGTATTGT
GTGTTAGACAG -> TGTTAGACAGT
GTTAACCATCC -> TTAACCATCCA
GTTAATAATCT -> TTAATAATCTG
GTTACGTCATC -> TTACGTCATCA
GTTACGTTTCA -> TTACGTTTCAT
GTTAGACAGTT -> TTAGACAGTTG
GTTAGCTGGGC -> TTAGCTGGGCA
GTTAGTATTCC -> TTAGTATTCCA
GTTATATCTGT -> TTATATCTGTA
GTTCAAGGTCA -> TTCAAGGTCAG
GTTCAGCTGCA -> TTCAGCTGCAA
GTTCCTGGTAC -> TTCCTGGTACA
GTTCGAAGGGC -> TTCGAAGGGCC
GTTCGTCGTGT -> TTCGTCGTGTA
GTTCTGTAGGC -> TTCTGTAGGCT
GTTCTTCCCTA -> TTCTTCCCTAG
GTTGAAGCGGT -> TTGAAGCGGTA
GTTGCACATTC -> TTGCACATTCC
GTTGCGCCACT -> TTGCGCCACTG
GTTGCGCTATT -> TTGCGCTATTA
GTTGCTAACCC -> TTGCTAACCCC
GTTGGGGCCTC -> TTGGGGCCTCT
GTTGGTTGTAA -> TTGGTTGTAAA
GTTGTAAACGC -> TTGTAAACGCC
GTTGTCGGCCG -> TTGTCGGCCGT
GTTGTTAATAA -> TTGTTAATAAT
GTTTAGGAATA -> TTTAGGAATAA
GTTTCAGAATT -> TTTCAGAATTG
GTTTCATACCC -> TTTCATACCCC
GTTTCGGTCAT -> TTTCGGTCATT
GTTTCTTAGAG -> TTTCTTAGAGG
TAAAATAGTGA -> AAAATAGTGAT
TAAACATTATT -> AAACATTATTA
TAAACCATTAC -> AAACCATTACC
TAAACGCCTCT -> AAACGCCTCTA
TAAAGCGACAG -> AAAGCGACAGA
TAAAGTCGAAT -> AAAGTCGAATG
TAAATCCGCCA -> AAATCCGCCAA
TAACAACGGGG -> AACAACGGGGC
TAACCATCCAA -> AACCATCCAAT
TAACCCCATCG -> AACCCCATCGA
TAACCCTCTTC -> AACCCTCTTCA
TAACCTTGTAT -> AACCTTGTATT
TAACGTCCCCA -> AACGTCCCCAA
TAAGAATGGAG -> AAGAATGGAGA
TAAGATACGAG -> AAGATACGAGG
TAAGCAATCTC -> AAGCAATCTCG
TAAGCACGGTG -> AAGCACGGTGG
TAAGCCCCCCT -> AAGCCCCCCTA
TAAGCCGAGTG -> AAGCCGAGTGG
TAAGCCTCTAC -> AAGCCTCTACC
TAAGGCAGTAC -> AAGGCAGTACC
TAAGTGAGTTG -> AAGTGAGTTGT
TAAGTTAGCTG -> AAGTTAGCTGG
TAAGTTCTGTA -> AAGTTCTGTAG
TAATAATCTGG -> AATAATCTGGA
TAATACCCGCA -> AATACCCGCAT
TAATCATCAAT -> AATCATCAATC
TAATCTAGGTA -> AATCTAGGTAG
TAATCTCAGGT -> AATCTCAGGTG
TAATCTGGAGT -> AATCTGGAGTC
TAATCTTAAGC -> AATCTTAAGCC
TAATGAAAATC -> AATGAAAATCC
TAATGGGCGCA -> AATGGGCGCAG
TAATTACCTGG -> AATTACCTGGT
TAATTCAAATG -> AATTCAAATGC
TAATTCCTCAT -> AATTCCTCATC
TAATTGGCGCG -> AATTGGCGCGA
TACAAATAAGC -> ACAAATAAGCT
TACAATTCAAA -> ACAATTCAAAT
TACAATTCAAG -> ACAATTCAAGG
TACACACTCCC -> ACACACTCCCG
TACACCACGTT -> ACACCACGTTG
TACAGTAATAC -> ACAGTAATACC
TACATCTTCTC -> ACATCTTCTCT
TACATGATCAC -> ACATGATCACT
TACCAATGGGC -> ACCAATGGGCC
TACCACCCATA -> ACCACCCATAA
TACCACCGGAC -> ACCACCGGACT
TACCAGAGTCG -> ACCAGAGTCGC
TACCCCTAAGA -> ACCCCTAAGAT
TACCCGCATCG -> ACCCGCATCGC
TACCGGTAGGC -> ACCGGTAGGCG
TACCTGGTAGT -> ACCTGGTAGTG
TACCTTCCCGT -> ACCTTCCCGTA
TACGAATTGGA -> ACGAATTGGAT
TACGAGGAAGT -> ACGAGGAAGTA
TACGATAGGTC -> ACGATAGGTCA
TACGTACCACC -> ACGTACCACCG
TACGTCATCAA -> ACGTCATCAAG
TACGTTTCATA -> ACGTTTCATAC
TACTACAATTC -> ACTACAATTCA
TACTAGAATCC -> ACTAGAATCCC
TACTCAACACT -> ACTCAACACTA
TACTCACAGAC -> ACTCACAGACG
TACTCCCCCTA -> ACTCCCCCTAT
TACTGTCCCAG -> ACTGTCCCAGA
TACTTACTTCT -> ACTTACTTCTT
TACTTCCTCAA -> ACTTCCTCAAT
TACTTCTTAAG -> ACTTCTTAAGG
TAGAACGACCC -> AGAACGACCCG
TAGAATCCCCT -> AGAATCCCCTT
TAGACAGCCCC -> AGACAGCCCCA
TAGACAGTTGC -> AGACAGTTGCA
TAGACCAAACC -> AGACCAAACCG
TAGAGGTACGA -> AGAGGTACGAA
TAGCAGCAGGG -> AGCAGCAGGGT
TAGCAGCGTTC -> AGCAGCGTTCG
TAGCATTACTC -> AGCATTACTCC
TAGCCTGGAGA -> AGCCTGGAGAC
TAGCGTGGTGG -> AGCGTGGTGGT
TAGCTGGGCAG -> AGCTGGGCAGT
TAGGAATAAAA -> AGGAATAAAAT
TAGGAGACTGA -> AGGAGACTGAT
TAGGCGGTAGA -> AGGCGGTAGAC
TAGGCTGAATA -> AGGCTGAATAT
TAGGCTGACTG -> AGGCTGACTGT
TAGGGGATTTT -> AGGGGATTTTG
TAGGGTATGAT -> AGGGTATGATG
TAGGGTCCCGA -> AGGGTCCCGAA
TAGGTAGGTGG -> AGGTAGGTGGA
TAGGTCAGGTG -> AGGTCAGGTGG
TAGGTGGAGCT -> AGGTGGAGCTG
TAGTAATTACC -> AGTAATTACCT
TAGTATTCCAG -> AGTATTCCAGA
TAGTCCTATCG -> AGTCCTATCGT
TAGTCGTCTGT -> AGTCGTCTGTG
TAGTCTTACTA -> AGTCTTACTAG
TAGTGATCTAG -> AGTGATCTAGC
TAGTGGGCGAT -> AGTGGGCGATG
TAGTTAGTATT -> AGTTAGTATTC
TAGTTGGTTGT -> AGTTGGTTGTA
TATAAGTTCTG -> ATAAGTTCTGT
TATACGATAGG -> ATACGATAGGT
TATACTCACAG -> ATACTCACAGA
TATAGACAGCC -> ATAGACAGCCC
TATAGCAGCAG -> ATAGCAGCAGG
TATAGGCTGAA -> ATAGGCTGAAT
TATAGGGGATT -> ATAGGGGATTT
TATATACGATA -> ATATACGATAG
TATATCGAAAC -> ATATCGAAACT
TATATCTGTAT -> ATATCTGTATG
TATCCCTCCGG -> ATCCCTCCGGC
TATCCGACTAC -> ATCCGACTACA
TATCCGAGTCG -> ATCCGAGTCGC
TATCCGTCATA -> ATCCGTCATAT
TATCGAAACTC -> ATCGAAACTCA
TATCGTGGGGT -> ATCGTGGGGTT
TATCTAATTGG -> ATCTAATTGGC
TATCTGTATGC -> ATCTGTATGCT
TATGAAATCGT -> ATGAAATCGTG
TATGATGCACA -> ATGATGCACAA
TATGATGCTAC -> ATGATGCTACG
TATGCTCTCAA -> ATGCTCTCAAG
TATGGCATCAG -> ATGGCATCAGG
TATGGGTTGCG -> ATGGGTTGCGC
TATTAAAGTCG -> ATTAAAGTCGA
TATTAAGAATG -> ATTAAGAATGG
TATTAAGTGAG -> ATTAAGTGAGT
TATTAGCGTGG -> ATTAGCGTGGT
TATTATGGCAT -> ATTATGGCATC
TATTCCAGAGT -> ATTCCAGAGTT
TATTCTATCCC -> ATTCTATCCCT
TATTCTGAATA -> ATTCTGAATAC
TATTGCGTACA -> ATTGCGTACAT
TATTGGCGGCA -> ATTGGCGGCAT
TATTGTCATCG -> ATTGTCATCGG
TCAAATGCACA -> CAAATGCACAC
TCAAATTCCCT -> CAAATTCCCTC
TCAACACTATA -> CAACACTATAT
TCAACGCCCGA -> CAACGCCCGAT
TCAAGACCAAA -> CAAGACCAAAC
TCAAGCGCTTG -> CAAGCGCTTGC
TCAAGGCATTT -> CAAGGCATTTT
TCAAGGGAAGC -> CAAGGGAAGCA
TCAAGGTCAGG -> CAAGGTCAGGT
TCAATCCCCCC -> CAATCCCCCCT
TCAATGTTCGA -> CAATGTTCGAA
TCACAGACGTT -> CACAGACGTTC
TCACCAACCAC -> CACCAACCACA
TCACCACCTCG -> CACCACCTCGG
TCACCTGGTCG -> CACCTGGTCGC
TCACGAACAGT -> CACGAACAGTA
TCACGGTGAGC -> CACGGTGAGCA
TCACTGCTCAT -> CACTGCTCATG
TCACTGGAAGG -> CACTGGAAGGC
TCACTTATTCT -> CACTTATTCTG
TCAGAATGCAA -> CAGAATGCAAT
TCAGAATTGCT -> CAGAATTGCTC
TCAGCTGCAAA -> CAGCTGCAAAG
TCAGGAGGATC -> CAGGAGGATCG
TCAGGTGGAGC -> CAGGTGGAGCT
TCAGGTGGTGG -> CAGGTGGTGGC
TCAGGTGTCGT -> CAGGTGTCGTG
TCAGTTACGTC -> CAGTTACGTCA
TCATAAGCACG -> CATAAGCACGG
TCATACCCCTA -> CATACCCCTAA
TCATATCTAAT -> CATATCTAATT
TCATCAAGACC -> CATCAAGACCA
TCATCAATCCC -> CATCAATCCCC
TCATCGACTGT -> CATCGACTGTA
TCATCGGAACC -> CATCGGAACCC
TCATCTAGTTG -> CATCTAGTTGG
TCATGAAGCCG -> CATGAAGCCGT
TCATGGGCGCC -> CATGGGCGCCG
TCATTCCTCCA -> CATTCCTCCAA
TCCAATACAGT -> CCAATACAGTA
TCCAATCCACC -> CCAATCCACCT
TCCAATGTCTA -> CCAATGTCTAT
TCCACAAGTGT -> CCACAAGTGTT
TCCACCTAAGC -> CCACCTAAGCA
TCCACGCGGTC -> CCACGCGGTCG
TCCAGAGTTGT -> CCAGAGTTGTC
TCCCAGATAGT -> CCCAGATAGTC
TCCCCAAGGCC -> CCCCAAGGCCG
TCCCCCCTAAT -> CCCCCCTAATG
TCCCCCTATTG -> CCCCCTATTGC
TCCCCTTGCCC -> CCCCTTGCCCT
TCCCGAACCGT -> CCCGAACCGTG
TCCCGAAGATT -> CCCGAAGATTG
TCCCGTACTTA -> CCCGTACTTAC
TCCCGTAGTCC -> CCCGTAGTCCT
TCCCTAATGAA -> CCCTAATGAAA
TCCCTAGGGTC -> CCCTAGGGTCC
TCCCTCCGGCA -> CCCTCCGGCAG
TCCCTCTTGCC -> CCCTCTTGCCA
TCCGACTACAA -> CCGACTACAAT
TCCGAGTCGCG -> CCGAGTCGCGC
TCCGCCAAGCA -> CCGCCAAGCAG
TCCGGCAGCCA -> CCGGCAGCCAT
TCCGTCATATC -> CCGTCATATCT
TCCGTTCAGCT -> CCGTTCAGCTG
TCCTACAAATA -> CCTACAAATAA
TCCTAGGAGAC -> CCTAGGAGACT
TCCTATCGTGG -> CCTATCGTGGG
TCCTCAATGTT -> CCTCAATGTTC
TCCTCATCTAG -> CCTCATCTAGT
TCCTCCAATAC -> CCTCCAATACA
TCCTGGTACAC -> CCTGGTACACA
TCCTGGTGGTA -> CCTGGTGGTAT
TCCTTACTCAA -> CCTTACTCAAC
TCCTTACTGTC -> CCTTACTGTCC
TCGAAACTCAT -> CGAAACTCATG
TCGAAGGGCCT -> CGAAGGGCCTC
TCGAATGCTCT -> CGAATGCTCTT
TCGAATGGAAC -> CGAATGGAACG
TCGACTGTAAT -> CGACTGTAATC
TCGAGGGGTGG -> CGAGGGGTGGA
TCGAGTAAACA -> CGAGTAAACAT
TCGCACTATTA -> CGCACTATTAA
TCGCAGTAAGC -> CGCAGTAAGCC
TCGCCTGCCGT -> CGCCTGCCGTC
TCGCGCCAACA -> CGCGCCAACAA
TCGCGCGACTA -> CGCGCGACTAC
TCGCTAAGTTA -> CGCTAAGTTAG
TCGCTCACCAA -> CGCTCACCAAC
TCGCTTGTTTA -> CGCTTGTTTAG
TCGGAACCCGG -> CGGAACCCGGG
TCGGAATAACC -> CGGAATAACCC
TCGGCCGTGGA -> CGGCCGTGGAA
TCGGGTTGCTA -> CGGGTTGCTAA
TCGGTCATTCC -> CGGTCATTCCT
TCGTATAGCAG -> CGTATAGCAGC
TCGTCAGTTAC -> CGTCAGTTACG
TCGTCGTGTAA -> CGTCGTGTAAT
TCGTCTGTGAT -> CGTCTGTGATC
TCGTGGGGTTC -> CGTGGGGTTCC
TCGTGTAATTC -> CGTGTAATTCC
TCGTGTCCCTA -> CGTGTCCCTAA
TCGTGTGGTAT -> CGTGTGGTATT
TCGTTTCGGTC -> CGTTTCGGTCA
TCTAAATCCGC -> CTAAATCCGCC
TCTAATTGGCG -> CTAATTGGCGC
TCTACCTTCCC -> CTACCTTCCCG
TCTAGCAGCGT -> CTAGCAGCGTT
TCTAGCATTAC -> CTAGCATTACT
TCTAGGTAGGT -> CTAGGTAGGTG
TCTAGTTGGTT -> CTAGTTGGTTG
TCTATCCCTCC -> CTATCCCTCCG
TCTATCCGAGT -> CTATCCGAGTC
TCTATTCTATC -> CTATTCTATCC
TCTCAAGCGCT -> CTCAAGCGCTT
TCTCACTTATT -> CTCACTTATTC
TCTCAGGTGGA -> CTCAGGTGGAG
TCTCGAGTAAA -> CTCGAGTAAAC
TCTCGCAGTAA -> CTCGCAGTAAG
TCTCTAGCAGC -> CTCTAGCAGCG
TCTCTCTAGCA -> CTCTCTAGCAG
TCTGAATACTA -> CTGAATACTAC
TCTGGAGTCAT -> CTGGAGTCATA
TCTGTAGGCTG -> CTGTAGGCTGA
TCTGTATGCTC -> CTGTATGCTCT
TCTGTCAGAAT -> CTGTCAGAATG
TCTGTGATCTT -> CTGTGATCTTA
TCTGTGCTCGT -> CTGTGCTCGTT
TCTGTTAACCA -> CTGTTAACCAT
TCTTAACAACG -> CTTAACAACGG
TCTTAAGCCGA -> CTTAAGCCGAG
TCTTAAGGCAG -> CTTAAGGCAGT
TCTTACTAGAA -> CTTACTAGAAT
TCTTAGAGGTA -> CTTAGAGGTAC
TCTTAGGGTAT -> CTTAGGGTATG
TCTTCACGGTG -> CTTCACGGTGA
TCTTCCCTAGG -> CTTCCCTAGGG
TCTTCTCTCTA -> CTTCTCTCTAG
TCTTGCCATCG -> CTTGCCATCGC
TCTTTCATCGA -> CTTTCATCGAC
TGAAAATATTA -> GAAAATATTAA
TGAAAATCCGT -> GAAAATCCGTT
TGAAAGGTGAA -> GAAAGGTGAAC
TGAAATCGTGT -> GAAATCGTGTC
TGAACACCTTA -> GAACACCTTAA
TGAAGCCGTTG -> GAAGCCGTTGG
TGAAGCCTCAC -> GAAGCCTCACG
TGAAGCGGATA -> GAAGCGGATAC
TGAAGCGGTAT -> GAAGCGGTATA
TGAATACTACA -> GAATACTACAA
TGAATATGGGT -> GAATATGGGTT
TGACAGGCTAA -> GACAGGCTAAT
TGACCTCCTTA -> GACCTCCTTAC
TGACGTAGTAA -> GACGTAGTAAT
TGACTAGTTAG -> GACTAGTTAGT
TGACTGTGAAA -> GACTGTGAAAA
TGAGCAGGGAA -> GAGCAGGGAAC
TGAGGAGTGCA -> GAGGAGTGCAA
TGAGGCTGTGG -> GAGGCTGTGGT
TGAGGGAAGGC -> GAGGGAAGGCG
TGAGTACCGGT -> GAGTACCGGTA
TGAGTTGTTAA -> GAGTTGTTAAT
TGATATATCGA -> GATATATCGAA
TGATCACTGCT -> GATCACTGCTC
TGATCTAGCAT -> GATCTAGCATT
TGATCTTAACA -> GATCTTAACAA
TGATGCACAAC -> GATGCACAACA
TGATGCTACGT -> GATGCTACGTA
TGCAAAGTCCC -> GCAAAGTCCCG
TGCAAGTGCTG -> GCAAGTGCTGA
TGCAATATCCG -> GCAATATCCGA
TGCACAACAGT -> GCACAACAGTG
TGCACACTCAC -> GCACACTCACT
TGCACATTCCT -> GCACATTCCTA
TGCCATCGCTA -> GCCATCGCTAA
TGCCCTATTAT -> GCCCTATTATG
TGCCGGCCCCT -> GCCGGCCCCTT
TGCCGTCTTAG -> GCCGTCTTAGG
TGCCGTTACGT -> GCCGTTACGTT
TGCGCCACTGT -> GCGCCACTGTG
TGCGCTATTAA -> GCGCTATTAAG
TGCGTACATGA -> GCGTACATGAT
TGCGTCTGTCA -> GCGTCTGTCAG
TGCGTGGAAAT -> GCGTGGAAATT
TGCGTTTCTTA -> GCGTTTCTTAG
TGCTAACCCCA -> GCTAACCCCAT
TGCTACGTACC -> GCTACGTACCA
TGCTCATGAAG -> GCTCATGAAGC
TGCTCGTATAG -> GCTCGTATAGC
TGCTCGTTTCG -> GCTCGTTTCGG
TGCTCTCAAGC -> GCTCTCAAGCG
TGCTCTTTCAT -> GCTCTTTCATC
TGCTGACCTCC -> GCTGACCTCCT
TGGAAATTGGT -> GGAAATTGGTT
TGGAACGGCGT -> GGAACGGCGTA
TGGAAGGCCTG -> GGAAGGCCTGT
TGGAATCACCA -> GGAATCACCAC
TGGAGACGTGA -> GGAGACGTGAG
TGGAGAGAAGA -> GGAGAGAAGAG
TGGAGCTGAGG -> GGAGCTGAGGA
TGGAGCTTTTC -> GGAGCTTTTCA
TGGAGTCATAA -> GGAGTCATAAG
TGGAGTTTCAG -> GGAGTTTCAGA
TGGATGAGGGA -> GGATGAGGGAA
TGGCATCAGGA -> GGCATCAGGAG
TGGCGCGATTT -> GGCGCGATTTC
TGGCGCGCTGT -> GGCGCGCTGTC
TGGCGGCATGA -> GGCGGCATGAC
TGGCTAATCTC -> GGCTAATCTCA
TGGGATACATC -> GGGATACATCT
TGGGCAGTGGC -> GGGCAGTGGCT
TGGGCCATCTC -> GGGCCATCTCG
TGGGCGATGAG -> GGGCGATGAGT
TGGGCGCAGGC -> GGGCGCAGGCC
TGGGCGCCGAC -> GGGCGCCGACT
TGGGGCCTCTG -> GGGGCCTCTGT
TGGGGTTCCTG -> GGGGTTCCTGG
TGGGTCAAGGC -> GGGTCAAGGCA
TGGGTTGCGCC -> GGGTTGCGCCA
TGGTACACACT -> GGTACACACTC
TGGTAGTGGGC -> GGTAGTGGGCG
TGGTATAGACA -> GGTATAGACAG
TGGTATTGTCA -> GGTATTGTCAT
TGGTCCTACAA -> GGTCCTACAAA
TGGTCGCTTGT -> GGTCGCTTGTT
TGGTGACAGGC -> GGTGACAGGCT
TGGTGGCGCGC -> GGTGGCGCGCT
TGGTGGTATAG -> GGTGGTATAGA
TGGTGGTGACA -> GGTGGTGACAG
TGGTTATATCT -> GGTTATATCTG
TGGTTCTTCCC -> GGTTCTTCCCT
TGGTTGTAAAC -> GGTTGTAAACG
TGTAAACGCCT -> GTAAACGCCTC
TGTAATCATCA -> GTAATCATCAA
TGTAATTCCTC -> GTAATTCCTCA
TGTAGGCTGAC -> GTAGGCTGACT
TGTATAGGCTG -> GTATAGGCTGA
TGTATGCTCTC -> GTATGCTCTCA
TGTATTGGCGG -> GTATTGGCGGC
TGTCAGAATGC -> GTCAGAATGCA
TGTCATCGGAA -> GTCATCGGAAC
TGTCCACAAGT -> GTCCACAAGTG
TGTCCACGCGG -> GTCCACGCGGT
TGTCCCAGATA -> GTCCCAGATAG
TGTCCCTAATG -> GTCCCTAATGA
TGTCCTTACTG -> GTCCTTACTGT
TGTCGGCCGTG -> GTCGGCCGTGG
TGTCGTGTGGT -> GTCGTGTGGTA
TGTCTATTCTA -> GTCTATTCTAT
TGTCTCACTTA -> GTCTCACTTAT
TGTGAAAATAT -> GTGAAAATATT
TGTGAAAGGTG -> GTGAAAGGTGA
TGTGATCTTAA -> GTGATCTTAAC
TGTGCTCGTTT -> GTGCTCGTTTC
TGTGGTATTGT -> GTGGTATTGTC
TGTGGTCCTAC -> GTGGTCCTACA
TGTGTGAAAGG -> GTGTGAAAGGT
TGTTAACCATC -> GTTAACCATCC
TGTTAATAATC -> GTTAATAATCT
TGTTAGACAGT -> GTTAGACAGTT
TGTTCGAAGGG -> GTTCGAAGGGC
TGTTTAGGAAT -> GTTTAGGAATA
TTAAAGTCGAA -> TAAAGTCGAAT
TTAACAACGGG -> TAACAACGGGG
TTAACCATCCA -> TAACCATCCAA
TTAACCTTGTA -> TAACCTTGTAT
TTAAGAATGGA -> TAAGAATGGAG
TTAAGCCGAGT -> TAAGCCGAGTG
TTAAGGCAGTA -> TAAGGCAGTAC
TTAAGTGAGTT -> TAAGTGAGTTG
TTAATAATCTG -> TAATAATCTGG
TTAATCTTAAG -> TAATCTTAAGC
TTACCAGAGTC -> TACCAGAGTCG
TTACCTGGTAG -> TACCTGGTAGT
TTACGTCATCA -> TACGTCATCAA
TTACGTTTCAT -> TACGTTTCATA
TTACTAGAATC -> TACTAGAATCC
TTACTCAACAC -> TACTCAACACT
TTACTCCCCCT -> TACTCCCCCTA
TTACTGTCCCA -> TACTGTCCCAG
TTACTTCTTAA -> TACTTCTTAAG
TTAGAACGACC -> TAGAACGACCC
TTAGACAGTTG -> TAGACAGTTGC
TTAGAGGTACG -> TAGAGGTACGA
TTAGCGTGGTG -> TAGCGTGGTGG
TTAGCTGGGCA -> TAGCTGGGCAG
TTAGGAATAAA -> TAGGAATAAAA
TTAGGGTATGA -> TAGGGTATGAT
TTAGTATTCCA -> TAGTATTCCAG
TTATATCTGTA -> TATATCTGTAT
TTATGGCATCA -> TATGGCATCAG
TTATTAGCGTG -> TATTAGCGTGG
TTATTCTGAAT -> TATTCTGAATA
TTCAAATGCAC -> TCAAATGCACA
TTCAAATTCCC -> TCAAATTCCCT
TTCAACGCCCG -> TCAACGCCCGA
TTCAAGGGAAG -> TCAAGGGAAGC
TTCAAGGTCAG -> TCAAGGTCAGG
TTCACGGTGAG -> TCACGGTGAGC
TTCAGAATTGC -> TCAGAATTGCT
TTCAGCTGCAA -> TCAGCTGCAAA
TTCATACCCCT -> TCATACCCCTA
TTCATCGACTG -> TCATCGACTGT
TTCCAATGTCT -> TCCAATGTCTA
TTCCAGAGTTG -> TCCAGAGTTGT
TTCCCGTACTT -> TCCCGTACTTA
TTCCCTAGGGT -> TCCCTAGGGTC
TTCCCTCTTGC -> TCCCTCTTGCC
TTCCTAGGAGA -> TCCTAGGAGAC
TTCCTCAATGT -> TCCTCAATGTT
TTCCTCATCTA -> TCCTCATCTAG
TTCCTCCAATA -> TCCTCCAATAC
TTCCTGGTACA -> TCCTGGTACAC
TTCGAAGGGCC -> TCGAAGGGCCT
TTCGAATGGAA -> TCGAATGGAAC
TTCGGTCATTC -> TCGGTCATTCC
TTCGTCGTGTA -> TCGTCGTGTAA
TTCTATCCCTC -> TCTATCCCTCC
TTCTCTCTAGC -> TCTCTCTAGCA
TTCTGAATACT -> TCTGAATACTA
TTCTGTAGGCT -> TCTGTAGGCTG
TTCTTAAGGCA -> TCTTAAGGCAG
TTCTTAGAGGT -> TCTTAGAGGTA
TTCTTCCCTAG -> TCTTCCCTAGG
TTGAAGCGGTA -> TGAAGCGGTAT
TTGCACATTCC -> TGCACATTCCT
TTGCCATCGCT -> TGCCATCGCTA
TTGCCCTATTA -> TGCCCTATTAT
TTGCCGGCCCC -> TGCCGGCCCCT
TTGCCGTTACG -> TGCCGTTACGT
TTGCGCCACTG -> TGCGCCACTGT
TTGCGCTATTA -> TGCGCTATTAA
TTGCGTACATG -> TGCGTACATGA
TTGCGTCTGTC -> TGCGTCTGTCA
TTGCGTGGAAA -> TGCGTGGAAAT
TTGCTAACCCC -> TGCTAACCCCA
TTGCTCGTATA -> TGCTCGTATAG
TTGGATGAGGG -> TGGATGAGGGA
TTGGCGCGATT -> TGGCGCGATTT
TTGGCGGCATG -> TGGCGGCATGA
TTGGGGCCTCT -> TGGGGCCTCTG
TTGGGTCAAGG -> TGGGTCAAGGC
TTGGTTCTTCC -> TGGTTCTTCCC
TTGGTTGTAAA -> TGGTTGTAAAC
TTGTAAACGCC -> TGTAAACGCCT
TTGTATTGGCG -> TGTATTGGCGG
TTGTCATCGGA -> TGTCATCGGAA
TTGTCCACAAG -> TGTCCACAAGT
TTGTCCACGCG -> TGTCCACGCGG
TTGTCGGCCGT -> TGTCGGCCGTG
TTGTTAATAAT -> TGTTAATAATC
TTGTTTAGGAA -> TGTTTAGGAAT
TTTAGGAATAA -> TTAGGAATAAA
TTTCAACGCCC -> TTCAACGCCCG
TTTCAGAATTG -> TTCAGAATTGC
TTTCATACCCC -> TTCATACCCCT
TTTCATCGACT -> TTCATCGACTG
TTTCCAATGTC -> TTCCAATGTCT
TTTCGAATGGA -> TTCGAATGGAA
TTTCGGTCATT -> TTCGGTCATTC
TTTCTTAGAGG -> TTCTTAGAGGT
TTTGTCCACGC -> TTGTCCACGCG
TTTTCAACGCC -> TTTCAACGCCC
TTTTCGAATGG -> TTTCGAATGGA
TTTTGTCCACG -> TTTGTCCACGC
TTTTTCGAATG -> TTTTCGAATGG
